一	一
丁	丁
七	七
万	万
丈	丈
三	三
上	上
下	下
丌	丌
不	不
丐	丐
丑	丑
且	且
丕	丕
世	世
丘	丘
丙	丙
丞	丞
丢	丟丢
丨	丨
丫	丫
丬	丬
中	中
丰	丰
串	串
丶	丶
丸	丸
丹	丹
主	主
丿	丿
乃	乃迺
久	久
乇	乇
么	么
之	之
乍	乍
乎	乎
乏	乏
乒	乒
乓	乓
乖	乖
乘	乘
乙	乙
乜	乜
九	九
乞	乞
也	也
乩	乩
乳	乳
乾	乾
亂	亂乱
了	了
予	予
争	爭争
事	事
二	二
亍	亍
于	于
云	云
互	互
亓	亓
五	五
井	井
亘	亘亙
些	些
亞	亞亚
亟	亟
亠	亠
亡	亡
亢	亢
交	交
亥	亥
亦	亦
亨	亨
享	享
京	京
亭	亭
亮	亮
亳	亳
人	人
亻	亻
什	什
仁	仁
仂	仂
仃	仃
仄	仄
仆	仆
仇	仇
仉	仉
今	今
介	介
仍	仍
仔	仔
仕	仕
他	他
仗	仗
付	付
仙	仙
仝	仝
仞	仞
仟	仟
仡	仡
代	代
令	令
以	以
仨	仨
仫	仫
仰	仰
仲	仲
仳	仳
仵	仵
件	件
价	价
任	任
份	份
仿	仿倣
企	企
伉	伉
伊	伊
伍	伍
伎	伎
伏	伏
伐	伐
休	休
伙	伙
伢	伢
伫	佇伫
伯	伯
估	估
伲	伲
伴	伴
伶	伶
伸	伸
伺	伺
似	似
伽	伽
佃	佃
但	但
位	位
低	低
住	住
佐	佐
佑	佑祐
何	何
佗	佗
佘	佘
余	余
佚	佚
佛	佛彿
作	作
佝	佝
佞	佞
佟	佟
你	你妳
佤	佤
佧	佧
佩	佩珮
佬	佬
佯	佯
佰	佰
佳	佳
佴	佴
佶	佶
佻	佻
佼	佼
佾	佾
使	使
侃	侃
侄	侄姪
來	來来
侈	侈
侉	侉
例	例
侍	侍
侏	侏
侑	侑
侔	侔
侖	侖仑崙
侗	侗
供	供
依	依
侣	侶侣
侮	侮
侯	侯
侵	侵
便	便
係	係
促	促
俄	俄
俅	俅
俊	俊
俎	俎
俏	俏
俐	俐
俑	俑
俗	俗
俘	俘
俚	俚
俜	俜
保	保
俞	俞
俟	俟
俠	俠侠
信	信
俣	俁俣
修	修脩
俯	俯
俱	俱
俳	俳
俸	俸
俺	俺
俾	俾
倀	倀伥
倆	倆俩
倉	倉仓
個	個个
倌	倌
倍	倍
倏	倏
們	們们
倒	倒
倔	倔
倘	倘
候	候
倚	倚
倜	倜
借	借
倡	倡
倥	倥
倦	倦
倨	倨
倩	倩
倪	倪
倫	倫伦
倬	倬
倭	倭
倮	倮
值	值
偃	偃
假	假
偈	偈
偉	偉伟
偌	偌
偎	偎
偏	偏
偕	偕
做	做
停	停
健	健
偬	傯偬
側	側侧
偵	偵侦
偶	偶
偷	偷
傀	傀
傅	傅
傈	傈
傍	傍徬
傖	傖伧
傘	傘伞
備	備备
傢	傢
傣	傣
催	催
傭	傭佣
傲	傲
傳	傳传
傴	傴伛
債	債债
傷	傷伤
傺	傺
傻	傻
傾	傾倾
僂	僂偻
僅	僅仅
僉	僉佥
像	像
僑	僑侨
僕	僕
僖	僖
僚	僚
僞	僞伪偽
僥	僥侥
僦	僦
僧	僧
僨	僨偾
僬	僬
僭	僭
僮	僮
僳	僳
僵	僵殭
價	價
僻	僻
儀	儀仪
儂	儂侬
億	億亿
儆	儆
儇	儇
儈	儈侩
儉	儉俭
儋	儋
儐	儐傧
儒	儒
儔	儔俦
儕	儕侪
儘	儘
償	償偿
儡	儡
優	優优
儲	儲储
儷	儷俪
儺	儺傩
儻	儻傥
儼	儼俨
兀	兀
允	允
元	元
兄	兄
充	充
兆	兆
先	先
光	光
克	克
免	免
兑	兌兑
兒	兒儿
兔	兔
兕	兕
兖	兗兖
党	党
兜	兜
兢	兢
入	入
全	全
兩	兩两
八	八
公	公
六	六
兮	兮
共	共
兵	兵
其	其
具	具
典	典
兹	茲兹
兼	兼
冀	冀
冂	冂
内	內内
冉	冉
册	冊册
再	再
冒	冒
冕	冕
冖	冖
冗	冗
冠	冠
冢	冢塚
冤	冤
冥	冥
冫	冫
冬	冬
冰	冰
冱	冱
冲	冲沖
决	決决
况	況况
冶	冶
冷	冷
冼	冼
冽	冽
净	淨净凈
凄	悽凄淒
准	准
凇	凇
凉	涼凉
凋	凋
凌	凌淩
凍	凍冻
减	減减
凑	湊凑
凛	凜凛
凝	凝
几	几
凡	凡
凭	凭
凰	凰
凱	凱凯
凳	凳
凵	凵
凶	凶兇
凸	凸
凹	凹
出	出
凼	凼
函	函
刀	刀
刁	刁
刂	刂
刃	刃
分	分
切	切
刈	刈
刊	刊
刎	刎
刑	刑
划	划
刖	刖
列	列
初	初
删	刪删
判	判
刨	刨鉋
利	利
别	別别
刮	刮
到	到
刳	刳
制	制
刷	刷
券	券
刹	剎刹
刺	刺
刻	刻
剁	剁
剃	剃
剄	剄刭
則	則则
削	削
剋	剋
剌	剌
前	前
剔	剔
剖	剖
剛	剛刚
剜	剜
剞	剞
剡	剡
剥	剝剥
剩	剩
剪	剪
剮	剮剐
副	副
割	割
剴	剴剀
創	創创
剽	剽
剿	剿勦
劁	劁
劂	劂
劃	劃
劇	劇剧
劈	劈
劉	劉刘
劊	劊刽
劌	劌刿
劍	劍剑
劐	劐
劑	劑剂
劓	劓
力	力
功	功
加	加
劣	劣
助	助
努	努
劫	劫
劬	劬
劭	劭
劾	劾
勁	勁劲
勃	勃
勇	勇
勉	勉
勐	勐
勒	勒
動	動动
勖	勖勗
勘	勘
務	務务
勛	勛勋勳
勝	勝胜
勞	勞劳
募	募
勢	勢势
勤	勤
勰	勰
勱	勱劢
勵	勵励
勸	勸劝
勹	勹
勺	勺
勾	勾
勿	勿
匀	勻匀
包	包
匆	匆
匈	匈
匍	匍
匏	匏
匐	匐
匕	匕
化	化
北	北
匙	匙
匚	匚
匝	匝
匠	匠
匡	匡
匣	匣
匪	匪
匭	匭匦
匯	匯汇
匱	匱匮
匹	匹
匾	匾
匿	匿
區	區区
十	十
千	千
卅	卅
升	升昇
午	午
卉	卉
半	半
卑	卑
卒	卒
卓	卓
協	協协
南	南
博	博
卜	卜
卞	卞
卟	卟
占	占佔
卡	卡
卣	卣
卦	卦
卧	臥卧
卩	卩
卮	卮
卯	卯
印	印
危	危
即	即
却	卻却
卵	卵
卷	卷
卸	卸
卺	巹卺
卿	卿
厂	厂
厄	厄
厘	厘釐
厙	厙厍
厚	厚
厝	厝
原	原
厠	厠厕廁
厢	廂厢
厥	厥
厦	廈厦
厨	廚厨
厩	廄厩
厭	厭厌
厮	廝厮
厲	厲厉
厴	厴厣
厶	厶
去	去
叁	叄叁
參	參参蔘
又	又
叉	叉
及	及
友	友
反	反
叔	叔
取	取
受	受
叙	敘叙
叛	叛
叟	叟
叠	疊叠
叢	叢丛
口	口
古	古
句	句
另	另
叨	叨
叩	叩
只	只
叫	叫
召	召
叭	叭
叮	叮
可	可
台	台
叱	叱
史	史
右	右
叵	叵
叶	叶
司	司
叻	叻
叼	叼
吁	吁
吃	吃
各	各
吆	吆
合	合
吉	吉
吊	吊弔
同	同
名	名
后	后
吏	吏
吐	吐
向	向
吒	吒
吕	呂吕
吖	吖
君	君
吝	吝
吞	吞
吟	吟
吠	吠
吡	吡
吣	吣
否	否
吧	吧
吩	吩
含	含
吭	吭
吮	吮
吱	吱
吲	吲
吴	吳吴
吵	吵
吸	吸
吹	吹
吻	吻
吼	吼
吾	吾
呀	呀
呃	呃
呆	呆
呈	呈
告	告
呋	呋
呐	吶呐
呔	呔
呢	呢
呤	呤
呦	呦
周	周週
呱	呱
呲	呲
味	味
呵	呵
呶	呶
呷	呷
呸	呸
呻	呻
呼	呼
命	命
咀	咀
咂	咂
咄	咄
咆	咆
咋	咋
和	和
咎	咎
咏	詠咏
咐	咐
咒	咒
咔	咔
咕	咕
咖	咖
咚	咚
咣	咣
咤	咤
咦	咦
咧	咧
咨	咨
咩	咩
咪	咪
咫	咫
咬	咬
咭	咭
咯	咯
咱	咱偺
咳	咳
咴	咴
咸	咸
咻	咻
咼	咼呙
咽	咽嚥
咿	咿
哀	哀
品	品
哂	哂
哄	哄閧鬨
哆	哆
哇	哇
哈	哈
哉	哉
哌	哌
哎	哎
哏	哏
哐	哐
哚	哚
哞	哞
員	員员
哥	哥
哦	哦
哧	哧
哨	哨
哩	哩
哪	哪
哭	哭
哮	哮
哲	哲
哳	哳
哺	哺
哼	哼
哽	哽
哿	哿
唁	唁
唄	唄呗
唆	唆
唇	唇脣
唉	唉
唏	唏
唐	唐
唑	唑
唔	唔
唣	唣
唤	喚唤
唧	唧
唪	唪
唬	唬
售	售
唯	唯
唰	唰
唱	唱
唳	唳
唷	唷
唼	唼
唾	唾
唿	唿
啁	啁
啃	啃
啄	啄
商	商
啉	啉
啊	啊
問	問问
啐	啐
啓	啓启啟
啕	啕
啖	啖
啜	啜
啞	啞哑
啡	啡
啤	啤
啥	啥
啦	啦
啪	啪
啵	啵
啶	啶
啷	啷
啻	啻
啼	啼
啾	啾
喀	喀
喁	喁
喂	喂餵
喃	喃
善	善
喇	喇
喈	喈
喉	喉
喊	喊
喋	喋
喏	喏
喑	喑
喔	喔
喘	喘
喙	喙
喜	喜
喝	喝
喟	喟
喧	喧
喪	喪丧
喬	喬乔
單	單单
喱	喱
喲	喲哟
喳	喳
喵	喵
喹	喹
喻	喻
嗄	嗄
嗅	嗅
嗆	嗆呛
嗇	嗇啬
嗉	嗉
嗌	嗌
嗍	嗍
嗎	嗎吗
嗑	嗑
嗒	嗒
嗓	嗓
嗔	嗔
嗖	嗖
嗚	嗚呜
嗜	嗜
嗝	嗝
嗟	嗟
嗡	嗡
嗣	嗣
嗤	嗤
嗥	嗥
嗦	嗦
嗨	嗨
嗩	嗩唢
嗪	嗪
嗬	嗬
嗯	嗯
嗲	嗲
嗵	嗵
嗶	嗶哔
嗷	嗷
嗽	嗽
嗾	嗾
嘀	嘀
嘁	嘁
嘆	嘆叹歎
嘈	嘈
嘉	嘉
嘌	嘌
嘍	嘍喽
嘎	嘎
嘏	嘏
嘔	嘔呕
嘖	嘖啧
嘗	嘗嚐尝
嘘	噓嘘
嘛	嘛
嘜	嘜唛
嘞	嘞
嘟	嘟
嘣	嘣
嘧	嘧
嘩	嘩哗譁
嘬	嘬
嘭	嘭
嘮	嘮唠
嘯	嘯啸
嘰	嘰叽
嘲	嘲
嘴	嘴
嘵	嘵哓
嘶	嘶
嘸	嘸呒
嘹	嘹
嘻	嘻
嘿	嘿
噁	噁
噌	噌
噍	噍
噎	噎
噔	噔
噗	噗
噘	噘
噙	噙
噝	噝咝
噠	噠哒
噢	噢
噤	噤
噥	噥哝
噦	噦哕
器	器
噩	噩
噪	噪
噫	噫
噬	噬
噯	噯嗳
噱	噱
噲	噲哙
噴	噴喷
噶	噶
噸	噸吨
噹	噹
噻	噻
噼	噼
嚀	嚀咛
嚅	嚅
嚆	嚆
嚇	嚇吓
嚌	嚌哜
嚎	嚎
嚏	嚏
嚓	嚓
嚕	嚕噜
嚙	嚙啮
嚦	嚦呖
嚨	嚨咙
嚮	嚮
嚯	嚯
嚳	嚳喾
嚴	嚴严
嚶	嚶嘤
嚷	嚷
嚼	嚼
囀	囀啭
囁	囁嗫
囂	囂嚣
囅	囅冁
囈	囈呓
囉	囉啰
囊	囊
囌	囌
囑	囑嘱
囔	囔
囗	囗
囚	囚
四	四
囝	囝
回	回
囟	囟
因	因
囡	囡
囤	囤
囫	囫
困	困
囱	囪囱
囹	囹
固	固
囿	囿
圃	圃
圄	圄
圇	圇囵
圈	圈
圉	圉
圊	圊
國	國国
圍	圍围
園	園园
圓	圓圆
圖	圖图
團	團团
圜	圜
土	土
在	在
圩	圩
圪	圪
圬	圬
圭	圭
圮	圮
圯	圯
地	地
圳	圳
圻	圻
圾	圾
址	址
坂	坂
均	均
坊	坊
坌	坌
坍	坍
坎	坎
坐	坐
坑	坑
坡	坡
坤	坤
坦	坦
坨	坨
坩	坩
坪	坪
坫	坫
坭	坭
坯	坯
坳	坳
坶	坶
坷	坷
坻	坻
坼	坼
垂	垂
垃	垃
型	型
垌	垌
垓	垓
垛	垛
垠	垠
垡	垡
垢	垢
垣	垣
垤	垤
垧	垧
垮	垮
垸	垸
埂	埂
埃	埃
埋	埋
城	城
埏	埏
埒	埒
埔	埔
埕	埕
埝	埝
域	域
埠	埠
埡	埡垭
埤	埤
埭	埭
埯	埯
埴	埴
執	執执
埸	埸
培	培
基	基
埽	埽
堀	堀
堂	堂
堅	堅坚
堆	堆
堇	堇
堊	堊垩
堋	堋
堍	堍
堖	堖垴
堙	堙
堝	堝埚
堞	堞
堠	堠
堡	堡
堤	堤
堪	堪
堯	堯尧
堰	堰
報	報报
場	場场
堵	堵
塄	塄
塊	塊块
塋	塋茔
塌	塌
塍	塍
塏	塏垲
塑	塑
塒	塒埘
塔	塔
塗	塗
塘	塘
塞	塞
塢	塢坞
塤	塤埙壎
塥	塥
填	填
塬	塬
塵	塵尘
塹	塹堑
塾	塾
墀	墀
墁	墁
境	境
墅	墅
墉	墉
墊	墊垫
墒	墒
墓	墓
墚	墚
墜	墜坠
增	增
墟	墟
墨	墨
墩	墩
墮	墮堕
墳	墳坟
墻	牆墙墻
墼	墼
墾	墾垦
壁	壁
壅	壅
壇	壇坛
壑	壑
壓	壓压
壕	壕
壘	壘垒
壙	壙圹
壚	壚垆
壞	壞坏
壟	壟垄
壠	壠垅
壢	壢坜
壤	壤
壩	壩坝
士	士
壬	壬
壯	壯壮
壹	壹
壺	壺壶
壽	壽寿
夂	夂
夏	夏
夔	夔
夕	夕
外	外
夙	夙
多	多
夜	夜
够	夠够
夢	夢梦
夤	夤
夥	夥
大	大
天	天
太	太
夫	夫伕
夭	夭
央	央
夯	夯
失	失
夷	夷
夸	夸
夼	夼
夾	夾夹
奂	奐奂
奄	奄
奇	奇
奈	奈
奉	奉
奎	奎
奏	奏
契	契
奔	奔
奕	奕
套	套
奘	奘
奚	奚
奠	奠
奢	奢
奥	奧奥
奩	奩奁
奪	奪夺
奬	獎奖奬
奮	奮奋
女	女
奴	奴
奶	奶
奸	奸姦
她	她
好	好
妁	妁
如	如
妃	妃
妄	妄
妊	妊
妍	妍
妒	妒
妓	妓
妖	妖
妗	妗
妙	妙
妝	妝妆
妞	妞
妣	妣
妤	妤
妥	妥
妨	妨
妮	妮
妯	妯
妲	妲
妹	妹
妻	妻
妾	妾
姆	姆
姊	姊
始	始
姐	姐
姑	姑
姒	姒
姓	姓
委	委
姗	姍姗
姘	姘
姚	姚
姜	姜
姝	姝
姣	姣
姥	姥
姨	姨
姬	姬
姹	奼姹
姻	姻
姿	姿
威	威
娃	娃
娉	娉
娌	娌
娑	娑
娓	娓
娘	娘孃
娜	娜
娟	娟
娠	娠
娣	娣
娥	娥
娩	娩
娱	娛娱
娶	娶
娼	娼
婀	婀
婁	婁娄
婆	婆
婉	婉
婊	婊
婕	婕
婚	婚
婢	婢
婦	婦妇
婧	婧
婪	婪
婭	婭娅
婷	婷
婺	婺
婿	婿
媒	媒
媚	媚
媛	媛
媧	媧娲
媪	媼媪
媲	媲
媳	媳
媵	媵
媸	媸
媽	媽妈
媾	媾
嫁	嫁
嫂	嫂
嫉	嫉
嫌	嫌
嫖	嫖
嫗	嫗妪
嫘	嫘
嫜	嫜
嫠	嫠
嫡	嫡
嫣	嫣
嫦	嫦
嫩	嫩
嫫	嫫
嫵	嫵妩
嫻	嫻娴
嬀	嬀妫
嬈	嬈娆
嬉	嬉
嬋	嬋婵
嬌	嬌娇
嬖	嬖
嬗	嬗
嬙	嬙嫱
嬡	嬡嫒
嬪	嬪嫔
嬰	嬰婴
嬲	嬲
嬴	嬴
嬷	嬤嬷
嬸	嬸婶
孀	孀
孌	孌娈
子	子
孑	孑
孓	孓
孔	孔
孕	孕
字	字
存	存
孚	孚
孛	孛
孜	孜
孝	孝
孟	孟
孢	孢
季	季
孤	孤
孥	孥
孩	孩
孫	孫孙
孬	孬
孰	孰
孱	孱
孳	孳
孵	孵
學	學学
孺	孺
孽	孽
孿	孿孪
宀	宀
它	它牠
宄	宄
宅	宅
宇	宇
守	守
安	安
宋	宋
完	完
宏	宏
宓	宓
宕	宕
宗	宗
官	官
宙	宙
定	定
宛	宛
宜	宜
客	客
宣	宣
室	室
宥	宥
宦	宦
宫	宫宮
宰	宰
害	害
宴	宴
宵	宵
家	家
宸	宸
容	容
宿	宿
寂	寂
寄	寄
寅	寅
密	密
寇	寇
富	富
寐	寐
寒	寒
寓	寓
寞	寞
察	察
寡	寡
寢	寢寝
寤	寤
寥	寥
實	實实
寧	寧宁
寨	寨
審	審审
寫	寫写
寬	寬宽
寮	寮
寰	寰
寵	寵宠
寶	寶宝
寸	寸
寺	寺
封	封
射	射
將	將将
專	專专
尉	尉
尊	尊
尋	尋寻
對	對对
導	導导
小	小
少	少
尕	尕
尖	尖
尚	尚
尜	尜
尢	尢
尤	尤
尥	尥
尬	尬
就	就
尷	尷尴
尸	尸屍
尹	尹
尺	尺
尻	尻
尼	尼
尾	尾
尿	尿
局	局侷跼
屁	屁
居	居
屈	屈
屉	屜屉
届	屆届
屋	屋
屎	屎
屏	屏
屐	屐
屑	屑
展	展
屙	屙
屠	屠
屢	屢屡
屣	屣
層	層层
履	履
屨	屨屦
屬	屬属
屮	屮
屯	屯
山	山
屹	屹
屺	屺
岈	岈
岌	岌
岍	岍
岐	岐
岑	岑
岔	岔
岙	岙
岜	岜
岡	岡冈
岢	岢
岣	岣
岩	岩巖
岫	岫
岬	岬
岱	岱
岳	岳嶽
岵	岵
岷	岷
岸	岸
峁	峁
峋	峋
峒	峒
峙	峙
峥	崢峥
峨	峨
峪	峪
峭	峭
峰	峯峰
峴	峴岘
島	島岛
峻	峻
峽	峽峡
崆	崆
崇	崇
崍	崍崃
崎	崎
崔	崔
崖	崖
崗	崗岗
崛	崛
崞	崞
崤	崤
崦	崦
崧	崧
崩	崩
崬	崬岽
崮	崮
崴	崴
崽	崽
崾	崾
嵇	嵇
嵊	嵊
嵋	嵋
嵌	嵌
嵐	嵐岚
嵛	嵛
嵩	嵩
嵫	嵫
嵬	嵬
嵯	嵯
嵴	嵴
嶁	嶁嵝
嶂	嶂
嶄	嶄崭
嶇	嶇岖
嶗	嶗崂
嶙	嶙
嶝	嶝
嶠	嶠峤
嶧	嶧峄
嶷	嶷
嶸	嶸嵘
嶺	嶺岭
嶼	嶼屿
巋	巋岿
巍	巍
巒	巒峦
巔	巔巅
巛	巛
川	川
州	州
巡	巡
巢	巢
工	工
左	左
巧	巧
巨	巨
巫	巫
差	差
巰	巰巯
己	己
已	已
巳	巳
巴	巴
巷	巷
巽	巽
巾	巾
市	市
布	布佈
帆	帆
希	希
帑	帑
帔	帔
帕	帕
帖	帖
帘	帘
帙	帙
帚	帚
帛	帛
帝	帝
帥	帥帅
師	師师
席	席蓆
帳	帳帐
帶	帶带
帷	帷
常	常
帽	帽
幀	幀帧
幂	冪幂
幃	幃帏
幄	幄
幅	幅
幌	幌
幔	幔
幕	幕
幗	幗帼
幘	幘帻
幛	幛
幞	幞
幟	幟帜
幡	幡
幢	幢
幣	幣币
幫	幫帮
幬	幬帱
干	干
平	平
年	年
并	並併并
幸	幸倖
幹	幹
幺	幺
幻	幻
幼	幼
幽	幽
幾	幾
广	广
庀	庀
庇	庇
床	牀床
庋	庋
序	序
底	底
庖	庖
店	店
庚	庚
府	府
庠	庠
庥	庥
度	度
座	座
庫	庫库
庭	庭
庳	庳
庵	庵菴
庶	庶
康	康
庸	庸
庹	庹
庾	庾
廉	廉
廊	廊
廑	廑
廒	廒
廓	廓
廖	廖
廛	廛
廟	廟庙
廠	廠厰
廡	廡庑
廢	廢废
廣	廣
廨	廨
廪	廩廪
廬	廬庐
廳	廳厅
廴	廴
延	延
廷	廷
建	建
廾	廾
廿	廿
弁	弁
异	異异
弃	棄弃
弄	弄
弈	弈
弊	弊
弋	弋
式	式
弑	弒弑
弓	弓
引	引
弗	弗
弘	弘
弛	弛
弟	弟
弦	弦絃
弧	弧
弩	弩
弭	弭
弱	弱
弳	弳弪
張	張张
强	強强
弼	弼
彀	彀
彆	彆
彈	彈弹
彌	彌弥
彎	彎弯
彐	彐
彖	彖
彗	彗
彘	彘
彙	彙
彝	彝彞彜
彡	彡
形	形
彤	彤
彦	彥彦
彩	彩綵
彪	彪
彬	彬
彭	彭
彰	彰
影	影
彳	彳
彷	彷
役	役
彼	彼
往	往
征	征
徂	徂
待	待
徇	徇
很	很
徉	徉
徊	徊
律	律
後	後
徐	徐
徑	徑径
徒	徒
得	得
徘	徘
徙	徙
徜	徜
從	從从
徠	徠徕
御	御
徨	徨
復	復复
循	循
徭	徭
微	微
徵	徵
德	德
徹	徹彻
徼	徼
徽	徽
心	心
忄	忄
必	必
忉	忉
忌	忌
忍	忍
忐	忐
忑	忑
忒	忒
忖	忖
志	志誌
忘	忘
忙	忙
忝	忝
忠	忠
忡	忡
忤	忤
忪	忪
快	快
忭	忭
忮	忮
忱	忱
念	念唸
忸	忸
忻	忻
忽	忽
忿	忿
怊	怊
怍	怍
怎	怎
怏	怏
怒	怒
怔	怔
怕	怕
怖	怖
怙	怙
怛	怛
思	思
怠	怠
怡	怡
急	急
怦	怦
性	性
怨	怨
怩	怩
怪	怪
怫	怫
怯	怯
怵	怵
恁	恁
恂	恂
恃	恃
恍	恍
恐	恐
恒	恆恒
恕	恕
恙	恙
恚	恚
恝	恝
恢	恢
恣	恣
恤	恤卹
恧	恧
恨	恨
恩	恩
恪	恪
恫	恫
恬	恬
恭	恭
息	息
恰	恰
恿	恿
悃	悃
悄	悄
悉	悉
悌	悌
悍	悍
悒	悒
悔	悔
悖	悖
悚	悚
悛	悛
悝	悝
悟	悟
悠	悠
患	患
悦	悅悦
您	您
悱	悱
悲	悲
悴	悴
悵	悵怅
悶	悶闷
悸	悸
悻	悻
悼	悼
情	情
惆	惆
惋	惋
惑	惑
惕	惕
惘	惘
惚	惚
惜	惜
惝	惝
惟	惟
惠	惠
惡	惡恶
惦	惦
惰	惰
惱	惱恼
惲	惲恽
想	想
惴	惴
惶	惶
惹	惹
惺	惺
惻	惻恻
愀	愀
愁	愁
愆	愆
愈	愈瘉癒
愉	愉
愍	愍
愎	愎
意	意
愕	愕
愚	愚
愛	愛爱
愜	愜惬
感	感
愠	慍愠
愣	愣
愧	愧
愫	愫
愴	愴怆
愷	愷恺
愾	愾忾
愿	愿
慈	慈
慊	慊
態	態态
慌	慌
慎	慎
慕	慕
慘	慘惨
慚	慚惭
慝	慝
慟	慟恸
慢	慢
慣	慣惯
慤	愨悫慤
慧	慧
慨	慨
慪	慪怄
慫	慫怂
慮	慮虑
慰	慰
慳	慳悭
慵	慵
慶	慶庆
慷	慷
憂	憂忧
憊	憊惫
憋	憋
憎	憎
憐	憐怜
憑	憑
憒	憒愦
憔	憔
憚	憚惮
憝	憝
憤	憤愤
憧	憧
憨	憨
憩	憩
憫	憫悯
憬	憬
憮	憮怃
憲	憲宪
憶	憶忆
憷	憷
憾	憾
懂	懂
懇	懇恳
懈	懈
應	應应
懊	懊
懋	懋
懌	懌怿
懔	懍懔
懞	懞
懟	懟怼
懣	懣懑
懦	懦
懨	懨恹
懲	懲惩
懵	懵
懶	懶懒
懷	懷怀
懸	懸悬
懺	懺忏
懼	懼惧
懾	懾慑
懿	懿
戀	戀恋
戇	戇戆
戈	戈
戊	戊
戌	戌
戍	戍
戎	戎
成	成
我	我
戒	戒
戔	戔戋
戕	戕
或	或
戚	戚慼
戛	戛
戟	戟
戡	戡
戢	戢
戤	戤
戥	戥
戧	戧戗
截	截
戬	戩戬
戮	戮
戰	戰战
戲	戲戏
戳	戳
戴	戴
户	戶户
戽	戽
戾	戾
房	房
所	所
扁	扁
扃	扃
扇	扇
扈	扈
扉	扉
手	手
扌	扌
才	才
扎	扎紮
扑	扑
扒	扒
打	打
扔	扔
托	托託
扛	扛
扣	扣釦
扦	扦
扭	扭
扮	扮
扯	扯
扳	扳
扶	扶
批	批
扼	扼
找	找
承	承
技	技
抄	抄
抉	抉
把	把
抑	抑
抒	抒
抓	抓
投	投
抖	抖
抗	抗
折	折
抛	拋抛
抨	抨
披	披
抬	抬
抱	抱
抵	抵牴
抹	抹
抻	抻
押	押
抽	抽
抿	抿
拂	拂
拄	拄
拆	拆
拇	拇
拈	拈
拉	拉
拊	拊
拌	拌
拍	拍
拎	拎
拐	拐枴柺
拒	拒
拓	拓
拔	拔
拖	拖
拗	拗
拘	拘
拙	拙
拚	拚
招	招
拜	拜
括	括
拭	拭
拮	拮
拯	拯
拱	拱
拳	拳
拴	拴
拶	拶
拷	拷
拼	拼
拽	拽
拾	拾
拿	拿
持	持
挂	挂掛
指	指
挈	挈
按	按
挎	挎
挑	挑
挖	挖
挣	掙挣
挨	挨
挪	挪
挫	挫
振	振
挲	挲
挹	挹
挺	挺
挽	挽輓
挾	挾挟
捂	捂
捃	捃
捅	捅
捆	捆梱綑
捉	捉
捋	捋
捌	捌
捍	捍
捎	捎
捏	捏
捐	捐
捕	捕
换	換换
捧	捧
捨	捨
捩	捩
捫	捫扪
捭	捭
据	据
捱	捱
捲	捲
捶	捶
捷	捷
捺	捺
捻	捻撚
掀	掀
掂	掂
掃	掃扫
掄	掄抡
掇	掇
授	授
掉	掉
掊	掊
掌	掌
掎	掎
掏	掏
掐	掐
排	排
掖	掖
掘	掘
掠	掠
探	探
掣	掣
接	接
控	控
推	推
掩	掩
措	措
掬	掬
掭	掭
掮	掮
掰	掰
掾	掾
揀	揀拣
揄	揄
揆	揆
揉	揉
揍	揍
揎	揎
描	描
提	提
插	插
揖	揖
揚	揚扬颺飏
揞	揞
揠	揠
握	握
揣	揣
揩	揩
揪	揪
揭	揭
揮	揮挥
揲	揲
援	援
揶	揶
揸	揸
搋	搋
搌	搌
損	損损
搏	搏
搐	搐
搓	搓
搔	搔
搗	搗捣
搛	搛
搜	搜蒐
搞	搞
搠	搠
搡	搡
搦	搦
搪	搪
搬	搬
搭	搭
搴	搴
搶	搶抢
携	攜携
搽	搽
搿	搿
摁	摁
摇	搖摇
摑	摑掴
摒	摒
摔	摔
摘	摘
摜	摜掼
摞	摞
摟	摟搂
摧	摧
摩	摩
摭	摭
摯	摯挚
摳	摳抠
摶	摶抟
摸	摸
摹	摹
摺	摺
摻	摻掺
撂	撂
撅	撅
撇	撇
撈	撈捞
撑	撐撑
撒	撒
撓	撓挠
撕	撕
撖	撖
撙	撙
撞	撞
撟	撟挢
撣	撣掸
撤	撤
撥	撥拨
撩	撩
撫	撫抚
撬	撬
播	播
撮	撮
撰	撰
撲	撲
撳	撳揿
撻	撻挞
撼	撼
撾	撾挝
撿	撿捡
擀	擀
擁	擁拥
擂	擂
擄	擄掳
擅	擅
擇	擇择
擊	擊击
擋	擋挡
操	操
擎	擎
擐	擐
擒	擒
擔	擔担
擗	擗
擘	擘
據	據
擠	擠挤
擢	擢
擤	擤
擦	擦
擬	擬拟
擯	擯摈
擰	擰拧
擱	擱搁
擲	擲掷
擴	擴扩
擷	擷撷
擺	擺摆
擻	擻擞
擼	擼撸
擾	擾扰
攀	攀
攄	攄摅
攆	攆撵
攉	攉
攏	攏拢
攔	攔拦
攖	攖撄
攘	攘
攙	攙搀
攛	攛撺
攝	攝摄
攢	攢攒
攣	攣挛
攤	攤摊
攥	攥
攪	攪搅
攫	攫
攬	攬揽
攮	攮
支	支
攴	攴
攵	攵
收	收
攸	攸
改	改
攻	攻
放	放
政	政
故	故
效	效
敉	敉
敏	敏
救	救
敕	敕
敖	敖
敗	敗败
教	教
敝	敝
敞	敞
敢	敢
散	散
敦	敦
敫	敫
敬	敬
敲	敲
整	整
敵	敵敌
敷	敷
數	數数
斂	斂敛
斃	斃毙
文	文
斌	斌
斐	斐
斑	斑
斕	斕斓
斗	斗
料	料
斛	斛
斜	斜
斟	斟
斡	斡
斤	斤
斥	斥
斧	斧
斫	斫
斬	斬斩
斯	斯
新	新
斷	斷断
方	方
於	於
施	施
旁	旁
旃	旃
旄	旄
旅	旅
旆	旆
旋	旋
旌	旌
旎	旎
族	族
旒	旒
旖	旖
旗	旗
既	既
日	日
旦	旦
旨	旨
早	早
旬	旬
旭	旭
旮	旮
旯	旯
旰	旰
旱	旱
旺	旺
昀	昀
昂	昂
昃	昃
昆	昆崑
昊	昊
昌	昌
明	明
昏	昏
易	易
昔	昔
昕	昕
昝	昝
星	星
映	映
春	春
昧	昧
昨	昨
昭	昭
是	是
昱	昱
昴	昴
昵	暱昵
昶	昶
晁	晁
時	時时
晃	晃
晋	晉晋
晌	晌
晏	晏
晗	晗
晚	晚
晝	晝昼
晟	晟
晡	晡
晤	晤
晦	晦
晨	晨
普	普
景	景
晰	晰
晴	晴
晶	晶
晷	晷
智	智
晾	晾
暄	暄
暇	暇
暈	暈晕
暉	暉晖
暌	暌
暑	暑
暖	暖
暗	暗
暝	暝
暢	暢畅
暨	暨
暫	暫暂
暮	暮
暴	暴
暹	暹
暾	暾
曄	曄晔
曆	曆
曇	曇昙
曉	曉晓
曖	曖暧
曙	曙
曛	曛
曜	曜
曝	曝
曠	曠旷
曦	曦
曩	曩
曬	曬晒
曰	曰
曲	曲
曳	曳
更	更
曷	曷
書	書书
曹	曹
曼	曼
曾	曾
替	替
最	最
會	會会
月	月
有	有
朊	朊
朋	朋
服	服
朐	朐
朔	朔
朕	朕
朗	朗
望	望
朝	朝
期	期
朦	朦
朧	朧胧矓
木	木
未	未
末	末
本	本
札	札
术	术朮
朱	朱
朴	朴
朵	朵
朽	朽
杆	杆桿
杈	杈
杉	杉
杌	杌
李	李
杏	杏
材	材
村	村
杓	杓
杖	杖
杜	杜
杞	杞
束	束
杠	杠槓
杪	杪
杭	杭
杯	杯盃
杰	杰傑
東	東东
杲	杲
杳	杳
杵	杵
杷	杷
杼	杼
松	松
板	板
枇	枇
枉	枉
枋	枋
析	析
枕	枕
林	林
枘	枘
枚	枚
果	果
枝	枝
枯	枯
枰	枰
枳	枳
枵	枵
架	架
枷	枷
枸	枸
柁	柁
柃	柃
柄	柄
柏	柏
某	某
柑	柑
柒	柒
染	染
柔	柔
柘	柘
柙	柙
柚	柚
柝	柝
柞	柞
柢	柢
查	查
柩	柩
柬	柬
柯	柯
柰	柰
柱	柱
柳	柳
柴	柴
柿	柿
栀	梔栀
栅	柵栅
栓	栓
栖	棲栖
栗	栗慄
栝	栝
校	校
栩	栩
株	株
栲	栲
栳	栳
核	核
根	根
格	格
栽	栽
桀	桀
桁	桁
桂	桂
桃	桃
桄	桄
桅	桅
框	框
案	案
桉	桉
桊	桊
桌	桌
桎	桎
桐	桐
桑	桑
桓	桓
桔	桔
桕	桕
桫	桫
桴	桴
桶	桶
桷	桷
梁	梁樑
梃	梃
梅	梅
梆	梆
梏	梏
梓	梓
梗	梗
梘	梘枧
條	條条
梟	梟枭
梢	梢
梧	梧
梨	梨
梭	梭
梯	梯
械	械
梳	梳
梵	梵
棉	棉
棋	棋
棍	棍
棒	棒
棕	棕
棖	棖枨
棗	棗枣
棘	棘
棚	棚
棟	棟栋
棠	棠
棣	棣
棧	棧栈
森	森
棰	棰
棱	棱稜
棵	棵
棹	棹櫂
棺	棺
棼	棼
椁	槨椁
椅	椅
椋	椋
植	植
椎	椎
椏	椏桠
椐	椐
椒	椒
椰	椰
椴	椴
椹	椹
椽	椽
椿	椿
楂	楂
楊	楊杨
楓	楓枫
楔	楔
楗	楗
楚	楚
楝	楝
楞	楞
楠	楠
楣	楣
楦	楦
楨	楨桢
楫	楫
業	業业
楮	楮
楱	楱
極	極极
楷	楷
楸	楸
楹	楹
榀	榀
概	概
榆	榆
榍	榍
榔	榔
榕	榕
榘	榘
榛	榛
榜	榜
榧	榧
榨	榨搾
榪	榪杩
榫	榫
榭	榭
榮	榮荣
榱	榱
榴	榴
榷	榷
榻	榻
榿	榿桤
槁	槁
槊	槊
構	構构
槌	槌
槍	槍枪
槎	槎
槐	槐
槔	槔
槧	槧椠
槭	槭
槲	槲
槳	槳桨
槽	槽
槿	槿
樁	樁桩
樂	樂乐
樅	樅枞
樊	樊
樓	樓楼
樗	樗
樘	樘
標	標标
樞	樞枢
樟	樟
模	模糢
樣	樣样
樨	樨
横	橫横
樵	樵
樸	樸
樹	樹树
樺	樺桦
樽	樽
樾	樾
橄	橄
橇	橇
橈	橈桡
橋	橋桥
橐	橐
橘	橘
橙	橙
橛	橛
機	機机
橡	橡
橢	橢椭
橥	櫫橥
橱	櫥橱
檀	檀
檄	檄
檉	檉柽
檎	檎
檐	檐簷
檑	檑
檔	檔档
檗	檗蘗
檜	檜桧
檠	檠
檢	檢检
檣	檣樯
檩	檁檩
檫	檫
檬	檬
檯	檯枱
檳	檳槟
檸	檸柠
檻	檻槛
櫃	櫃柜
櫓	櫓橹
櫚	櫚榈
櫛	櫛栉
櫝	櫝椟
櫞	櫞橼
櫟	櫟栎
櫧	櫧槠
櫨	櫨栌
櫪	櫪枥
櫬	櫬榇
櫳	櫳栊
櫸	櫸榉
櫻	櫻樱
欄	欄栏
權	權权
欏	欏椤
欒	欒栾
欖	欖榄
欞	欞棂
欠	欠
次	次
欣	欣
欲	欲慾
欷	欷
欹	欹
欺	欺
欽	欽钦
款	款
歃	歃
歆	歆
歇	歇
歉	歉
歌	歌
歐	歐欧
歙	歙
歟	歟欤
歡	歡欢
止	止
正	正
此	此
步	步
武	武
歧	歧
歪	歪
歲	歲岁
歷	歷历
歸	歸归
歹	歹
死	死
殁	歿殁
殂	殂
殃	殃
殄	殄
殆	殆
殉	殉
殊	殊
殍	殍
殖	殖
殘	殘残
殛	殛
殞	殞殒
殤	殤殇
殪	殪
殫	殫殚
殮	殮殓
殯	殯殡
殲	殲歼
殳	殳
段	段
殷	殷慇
殺	殺杀
殻	殼壳殻
殿	殿
毁	毀毁燬譭
毅	毅
毆	毆殴
毋	毋
母	母
每	每
毒	毒
毓	毓
比	比
毖	毖
毗	毗
毛	毛
毪	毪
毫	毫
毯	毯
毳	毳
毹	毹
毽	毽
毿	毿毵
氅	氅
氆	氆
氈	氈毡
氌	氌氇
氍	氍
氏	氏
氐	氐
民	民
氓	氓
氕	氕
氖	氖
氘	氘
氙	氙
氚	氚
氛	氛
氟	氟
氡	氡
氣	氣气
氤	氤
氦	氦
氧	氧
氨	氨
氪	氪
氫	氫氢
氬	氬氩
氮	氮
氯	氯
氰	氰
氲	氳氲
水	水
氵	氵
永	永
氽	氽
汀	汀
汁	汁
求	求
汆	汆
汊	汊
汐	汐
汔	汔
汕	汕
汗	汗
汛	汛
汜	汜
汝	汝
汞	汞
江	江
池	池
污	污汙
汨	汨
汩	汩
汪	汪
汰	汰
汲	汲
汴	汴
汶	汶
汹	洶汹
汽	汽
汾	汾
沁	沁
沂	沂
沃	沃
沅	沅
沆	沆
沈	沈
沉	沉
沌	沌
沏	沏
沐	沐
沓	沓
沔	沔
沙	沙
沛	沛
没	沒没
沫	沫
沭	沭
沮	沮
沱	沱
沲	沲
河	河
沸	沸
油	油
治	治
沼	沼
沽	沽
沾	沾霑
沿	沿
泄	泄
泅	泅
泉	泉
泊	泊
泌	泌
泐	泐
泓	泓
泔	泔
法	法
泖	泖
泗	泗
泛	泛氾
泠	泠
泡	泡
波	波
泣	泣
泥	泥
注	注註
泪	淚泪
泫	泫
泮	泮
泯	泯
泰	泰
泱	泱
泳	泳
泵	泵
洄	洄
洇	洇
洋	洋
洌	洌
洎	洎
洗	洗
洙	洙
洚	洚
洛	洛
洞	洞
津	津
洧	洧
洪	洪
洫	洫
洮	洮
洱	洱
洲	洲
洳	洳
洵	洵
洹	洹
活	活
洽	洽
派	派
流	流
浙	浙
浚	浚濬
浜	浜
浞	浞
浠	浠
浣	浣
浦	浦
浩	浩
浪	浪
浮	浮
浯	浯
浴	浴
海	海
浸	浸
浹	浹浃
浼	浼
涂	涂
涅	涅
涇	涇泾
消	消
涉	涉
涌	涌湧
涎	涎
涑	涑
涓	涓
涔	涔
涕	涕
涣	渙涣
涪	涪
涫	涫
涮	涮
涯	涯
液	液
涵	涵
涸	涸
涿	涿
淀	淀
淄	淄
淅	淅
淆	淆
淇	淇
淋	淋
淌	淌
淑	淑
淖	淖
淘	淘
淙	淙
淝	淝
淞	淞
淠	淠
淡	淡
淤	淤
淦	淦
淪	淪沦
淫	淫
淬	淬
淮	淮
深	深
淳	淳
淵	淵渊
淶	淶涞
混	混
淹	淹
淺	淺浅
添	添
淼	淼
清	清
渌	淥渌
渚	渚
渝	渝
渠	渠
渡	渡
渣	渣
渤	渤
渥	渥
渦	渦涡
温	溫温
渫	渫
測	測测
渭	渭
港	港
渲	渲
渴	渴
游	游遊
渺	渺
渾	渾浑
湃	湃
湄	湄
湍	湍
湎	湎
湓	湓
湔	湔
湖	湖
湘	湘
湛	湛
湞	湞浈
湟	湟
湫	湫
湮	湮
湯	湯汤
溆	漵溆
溉	溉
溏	溏
源	源
準	準
溘	溘
溜	溜
溝	溝沟
溟	溟
溢	溢
溥	溥
溧	溧
溪	溪谿
溯	溯
溱	溱
溲	溲
溴	溴
溶	溶
溷	溷
溺	溺
溻	溻
溽	溽
滁	滁
滂	滂
滄	滄沧
滅	滅灭
滇	滇
滋	滋
滌	滌涤
滎	滎荥
滏	滏
滑	滑
滓	滓
滔	滔
滕	滕
滚	滾滚
滬	滬沪
滯	滯滞
滲	滲渗
滴	滴
滷	滷
滸	滸浒
滹	滹
滿	滿满
漁	漁渔
漂	漂
漆	漆
漉	漉
漏	漏
演	演
漕	漕
漚	漚沤
漠	漠
漢	漢汉
漣	漣涟
漤	漤
漩	漩
漪	漪
漫	漫
漬	漬渍
漭	漭
漯	漯
漱	漱
漲	漲涨
漳	漳
漶	漶
漸	漸渐
漾	漾
漿	漿浆
潁	潁颍
潑	潑泼
潔	潔洁
潘	潘
潙	潙沩
潜	潛潜
潞	潞
潢	潢
潤	潤润
潦	潦
潭	潭
潮	潮
潯	潯浔
潰	潰溃
潲	潲
潴	瀦潴
潷	潷滗
潸	潸
潺	潺
潼	潼
潿	潿涠
澀	澀涩
澄	澄
澆	澆浇
澇	澇涝
澈	澈
澉	澉
澌	澌
澍	澍
澎	澎
澗	澗涧
澠	澠渑
澡	澡
澤	澤泽
澧	澧
澩	澩泶
澮	澮浍
澱	澱
澳	澳
澶	澶
澹	澹
激	激
濁	濁浊
濂	濂
濃	濃浓
濉	濉
濕	濕湿溼
濘	濘泞
濛	濛
濞	濞
濟	濟济
濠	濠
濡	濡
濤	濤涛
濫	濫滥
濮	濮
濯	濯
濰	濰潍
濱	濱滨
濺	濺溅
濼	濼泺
濾	濾滤
瀅	瀅滢
瀆	瀆渎
瀉	瀉泻
瀋	瀋渖
瀏	瀏浏
瀑	瀑
瀕	瀕濒
瀘	瀘泸
瀚	瀚
瀛	瀛
瀝	瀝沥
瀟	瀟潇
瀠	瀠潆
瀣	瀣
瀧	瀧泷
瀨	瀨濑
瀰	瀰
瀲	瀲潋
瀵	瀵
瀹	瀹
瀾	瀾澜
灃	灃沣
灄	灄滠
灌	灌
灑	灑洒
灕	灕漓
灘	灘滩
灝	灝灏
灞	灞
灣	灣湾
灤	灤滦
灧	灧滟
火	火
灬	灬
灰	灰
灸	灸
灼	灼
灾	災灾
炅	炅
炊	炊
炎	炎
炒	炒
炔	炔
炕	炕
炖	燉炖
炙	炙
炫	炫
炬	炬
炭	炭
炮	炮
炯	炯
炱	炱
炳	炳
炷	炷
炸	炸
炻	炻
烀	烀
烈	烈
烊	烊
烏	烏乌
烘	烘
烙	烙
烟	煙烟
烤	烤
烯	烯
烴	烴烃
烷	烷
烹	烹
烽	烽
焉	焉
焊	焊
焐	焐
焓	焓
焕	煥焕
焙	焙
焚	焚
無	無无
焦	焦
焯	焯
焰	焰燄
焱	焱
然	然
煅	煅
煉	煉炼鍊
煊	煊
煌	煌
煎	煎
煒	煒炜
煜	煜
煞	煞
煢	煢茕
煤	煤
煦	煦
照	照
煨	煨
煩	煩烦
煬	煬炀
煮	煮
煲	煲
煳	煳
煸	煸
煺	煺
煽	煽
熄	熄
熊	熊
熏	熏燻
熒	熒荧
熔	熔鎔镕
熗	熗炝
熘	熘
熙	熙
熟	熟
熠	熠
熨	熨
熬	熬
熱	熱热
熳	熳
熵	熵
熹	熹
熾	熾炽
燁	燁烨
燃	燃
燈	燈灯
燎	燎
燒	燒烧
燔	燔
燕	燕
燙	燙烫
燜	燜焖
營	營营
燠	燠
燥	燥
燦	燦灿
燧	燧
燭	燭烛
燮	燮
燴	燴烩
燹	燹
燼	燼烬
燾	燾焘
爆	爆
爍	爍烁
爐	爐炉
爛	爛烂
爝	爝
爨	爨
爪	爪
爬	爬
爰	爰
爲	爲为為
爵	爵
父	父
爸	爸
爹	爹
爺	爺爷
爻	爻
爽	爽
爾	爾尔
爿	爿
片	片
版	版
牌	牌
牒	牒
牖	牖
牘	牘牍
牙	牙
牛	牛
牝	牝
牟	牟
牡	牡
牢	牢
牦	犛牦
牧	牧
物	物
牮	牮
牯	牯
牲	牲
特	特
牽	牽牵
牾	牾
牿	牿
犀	犀
犁	犁
犄	犄
犋	犋
犍	犍
犏	犏
犒	犒
犖	犖荦
犟	犟
犢	犢犊
犧	犧牺
犬	犬
犭	犭
犯	犯
犰	犰
犴	犴
狀	狀状
狁	狁
狂	狂
狃	狃
狄	狄
狍	狍
狎	狎
狐	狐
狒	狒
狗	狗
狙	狙
狠	狠
狡	狡
狨	狨
狩	狩
狰	猙狰
狳	狳
狴	狴
狷	狷
狸	狸貍
狹	狹狭
狺	狺
狻	狻
狼	狼
狽	狽狈
猁	猁
猊	猊
猓	猓
猖	猖
猗	猗
猛	猛
猜	猜
猝	猝
猞	猞
猢	猢
猥	猥
猩	猩
猪	豬猪
猫	貓猫
猬	蝟猬
猱	猱
猴	猴
猶	猶犹
猷	猷
猸	猸
猹	猹
猻	猻狲
猾	猾
猿	猿
獁	獁犸
獄	獄狱
獅	獅狮
獍	獍
獐	獐
獒	獒
獗	獗
獠	獠
獨	獨独
獪	獪狯
獫	獫猃
獬	獬
獯	獯
獰	獰狞
獲	獲获
獵	獵猎
獷	獷犷
獸	獸兽
獺	獺獭
獻	獻献
獼	獼猕
獾	獾
玀	玀猡
玄	玄
率	率
玉	玉
王	王
玎	玎
玖	玖
玟	玟
玢	玢
玩	玩
玫	玫
玲	玲
玳	玳
玷	玷
玻	玻
珀	珀
珂	珂
珈	珈
珉	珉
珊	珊
珍	珍
珏	珏玨
珐	琺珐
珙	珙
珞	珞
珠	珠
珥	珥
珧	珧
珩	珩
班	班
現	現现
球	球
琅	琅瑯
理	理
琉	琉
琊	琊
琚	琚
琛	琛
琢	琢
琥	琥
琦	琦
琨	琨
琪	琪
琬	琬
琮	琮
琰	琰
琳	琳
琴	琴
琵	琵
琶	琶
琿	琿珲
瑁	瑁
瑋	瑋玮
瑕	瑕
瑗	瑗
瑙	瑙
瑚	瑚
瑛	瑛
瑜	瑜
瑞	瑞
瑟	瑟
瑣	瑣琐
瑩	瑩莹
瑪	瑪玛
瑭	瑭
瑰	瑰
瑶	瑤瑶
瑾	瑾
璀	璀
璁	璁
璃	璃琍
璇	璇
璉	璉琏
璋	璋
璐	璐
璜	璜
璞	璞
璣	璣玑
璦	璦瑷
璧	璧
璨	璨
璩	璩
環	環环
璺	璺
璽	璽玺
瓊	瓊琼
瓏	瓏珑
瓔	瓔璎
瓚	瓚瓒
瓜	瓜
瓞	瓞
瓠	瓠
瓢	瓢
瓣	瓣
瓤	瓤
瓦	瓦
瓮	甕瓮
瓴	瓴
瓶	瓶
瓷	瓷
瓿	瓿
甄	甄
甌	甌瓯
甍	甍
甏	甏
甑	甑
甓	甓
甘	甘
甙	甙
甚	甚
甜	甜
生	生
産	產产産
甥	甥
用	用
甩	甩
甫	甫
甬	甬
甭	甭
甯	甯
田	田
由	由
甲	甲
申	申
男	男
甸	甸
町	町
甾	甾
畀	畀
畈	畈
畋	畋
界	界
畎	畎甽
畏	畏
畔	畔
留	留
畚	畚
畛	畛
畜	畜
畝	畝亩
畢	畢毕
略	略
畦	畦
番	番
畫	畫画
畲	畲畬
當	當当
畸	畸
畹	畹
畿	畿
疃	疃
疆	疆
疇	疇畴
疋	疋
疏	疏
疑	疑
疒	疒
疔	疔
疙	疙
疚	疚
疝	疝
疣	疣
疤	疤
疥	疥
疫	疫
疰	疰
疱	皰疱
疲	疲
疳	疳
疴	痾疴
疵	疵
疸	疸
疹	疹
疼	疼
疽	疽
疾	疾
痂	痂
痃	痃
痄	痄
病	病
症	症
痊	痊
痍	痍
痔	痔
痕	痕
痘	痘
痙	痙痉
痛	痛
痞	痞
痢	痢
痣	痣
痤	痤
痦	痦
痧	痧
痪	瘓痪
痰	痰
痱	痱
痴	癡痴
痹	痹痺
痼	痼
痿	痿
瘀	瘀
瘁	瘁
瘂	瘂痖
瘃	瘃
瘊	瘊
瘋	瘋疯
瘌	瘌
瘍	瘍疡
瘐	瘐
瘕	瘕
瘙	瘙
瘛	瘛
瘞	瘞瘗
瘟	瘟
瘠	瘠
瘡	瘡疮
瘢	瘢
瘤	瘤
瘥	瘥
瘦	瘦
瘧	瘧疟
瘩	瘩
瘭	瘭
瘰	瘰
瘳	瘳
瘴	瘴
瘵	瘵
瘸	瘸
瘻	瘻瘘
瘼	瘼
癀	癀
療	療疗
癃	癃
癆	癆痨
癇	癇痫
癉	癉瘅
癌	癌
癍	癍
癔	癔
癖	癖
癘	癘疠
癜	癜
癟	癟瘪
癢	癢痒
癤	癤疖
癥	癥
癧	癧疬
癩	癩癞
癬	癬癣
癭	癭瘿
癮	癮瘾
癯	癯
癰	癰痈
癱	癱瘫
癲	癲癫
癸	癸
登	登
發	發发
白	白
百	百
皂	皂
的	的
皆	皆
皇	皇
皈	皈
皋	皋臯皐
皎	皎
皓	皓
皖	皖
皙	皙
皚	皚皑
皤	皤
皮	皮
皴	皴
皸	皸皲
皺	皺皱
皿	皿
盂	盂
盅	盅
盆	盆
盈	盈
益	益
盍	盍
盎	盎
盒	盒
盔	盔
盗	盜盗
盛	盛
盞	盞盏
盟	盟
盡	盡尽
監	監监
盤	盤盘
盥	盥
盧	盧卢
目	目
盯	盯
盱	盱
盲	盲
直	直
相	相
盹	盹
盼	盼
盾	盾
省	省
眄	眄
眇	眇
眈	眈
眉	眉
看	看
眙	眙
眚	眚
真	真
眠	眠
眢	眢
眦	眥眦
眨	眨
眩	眩
眭	眭
眯	眯瞇
眵	眵
眶	眶
眷	眷
眸	眸
眺	眺
眼	眼
着	着
睁	睜睁
睃	睃
睇	睇
睏	睏
睚	睚
睛	睛
睞	睞睐
睡	睡
睢	睢
督	督
睥	睥
睦	睦
睨	睨
睫	睫
睬	睬
睹	睹
睽	睽
睾	睾睪
睿	睿
瞀	瞀
瞄	瞄
瞅	瞅
瞌	瞌
瞍	瞍
瞎	瞎
瞑	瞑
瞘	瞘眍
瞞	瞞瞒
瞟	瞟
瞠	瞠
瞢	瞢
瞥	瞥
瞧	瞧
瞪	瞪
瞬	瞬
瞭	瞭
瞰	瞰
瞳	瞳
瞵	瞵
瞻	瞻
瞼	瞼睑
瞽	瞽
瞿	瞿
矇	矇
矍	矍
矗	矗
矚	矚瞩
矛	矛
矜	矜
矢	矢
矣	矣
知	知
矧	矧
矩	矩
矬	矬
短	短
矮	矮
矯	矯矫
石	石
矸	矸
矽	矽
砂	砂
砉	砉
砌	砌
砍	砍
砑	砑
砒	砒
研	研
砘	砘
砝	砝
砟	砟
砣	砣
砥	砥
砦	砦
砧	砧
砩	砩
砬	砬
砭	砭
砰	砰
破	破
砷	砷
砸	砸
砹	砹
砼	砼
硃	硃
硅	硅
硇	硇
硌	硌
硎	硎
硐	硐
硒	硒
硝	硝
硤	硤硖
硨	硨砗
硪	硪
硫	硫
硬	硬
硭	硭
确	确
硯	硯砚
硼	硼
碇	碇
碉	碉
碌	碌
碎	碎
碑	碑
碓	碓
碗	碗
碘	碘
碚	碚
碟	碟
碡	碡
碣	碣
碥	碥
碧	碧
碩	碩硕
碭	碭砀
碰	碰踫
碱	碱
碲	碲
碳	碳
碴	碴
碸	碸砜
碹	碹
確	確
碼	碼码
碾	碾
磁	磁
磅	磅
磉	磉
磊	磊
磋	磋
磐	磐
磔	磔
磕	磕
磙	磙
磚	磚砖
磣	磣碜
磧	磧碛
磨	磨
磬	磬
磯	磯矶
磲	磲
磴	磴
磷	磷燐
磺	磺
磽	磽硗
礁	礁
礅	礅
礎	礎础
礓	礓
礙	礙碍
礞	礞
礤	礤
礦	礦矿
礪	礪砺
礫	礫砾
礬	礬矾
礱	礱砻
礴	礴
示	示
礻	礻
社	社
祀	祀
祁	祁
祆	祆
祈	祈
祉	祉
祓	祓
祖	祖
祗	祗
祚	祚
祛	祛
祜	祜
祝	祝
神	神
祟	祟
祠	祠
祥	祥
祧	祧
票	票
祭	祭
祺	祺
禀	稟禀
禁	禁
禄	祿禄
禊	禊
禍	禍祸
禎	禎祯
福	福
禚	禚
禦	禦
禧	禧
禪	禪禅
禮	禮礼
禰	禰祢
禱	禱祷
禳	禳
禹	禹
禺	禺
禽	禽
禾	禾
秀	秀
私	私
秃	禿秃
秆	稈秆
秉	秉
秋	秋
种	种
科	科
秒	秒
秕	秕
秘	祕秘
租	租
秣	秣
秤	秤
秦	秦
秧	秧
秩	秩
秫	秫
秭	秭
秸	秸
移	移
稀	稀
稂	稂
稃	稃
稆	穭稆
程	程
稍	稍
税	稅税
稔	稔
稗	稗
稚	稚
稞	稞
稠	稠
種	種
稱	稱称
稷	稷
稹	稹
稻	稻
稼	稼
稽	稽
稿	稿
穀	穀
穆	穆
穌	穌稣
積	積积
穎	穎颖
穗	穗
穡	穡穑
穢	穢秽
穩	穩稳
穫	穫
穰	穰
穴	穴
究	究
穸	穸
穹	穹
空	空
穿	穿
窀	窀
突	突
窄	窄
窆	窆
窈	窈
窑	窯窑
窒	窒
窕	窕
窖	窖
窗	窗
窘	窘
窟	窟
窠	窠
窨	窨
窩	窩窝
窪	窪洼
窬	窬
窮	窮穷
窳	窳
窶	窶窭
窺	窺窥
窿	窿
竄	竄窜
竅	竅窍
竇	竇窦
竈	竈灶
竊	竊窃
立	立
站	站
竟	竟
章	章
竣	竣
童	童
竦	竦
竪	豎竖竪
竭	竭
端	端
競	競竞
竹	竹
竺	竺
竽	竽
竿	竿
笄	笄
笆	笆
笈	笈
笊	笊
笋	筍笋
笏	笏
笑	笑
笙	笙
笛	笛
笞	笞
笠	笠
笤	笤
笥	笥
符	符
笨	笨
笪	笪
笫	笫
第	第
笮	笮
笱	笱
笳	笳
笸	笸
筅	筅
筆	筆笔
筇	筇
等	等
筋	筋
筌	筌
筏	筏
筐	筐
筑	筑
筒	筒
答	答
策	策
筘	筘
筝	箏筝
筠	筠
筢	筢
筧	筧笕
筮	筮
筱	筱
筲	筲
筵	筵
筷	筷
筻	筻
箅	箅
箋	箋笺
箍	箍
箐	箐
箔	箔
箕	箕
算	算
箜	箜
箝	箝
管	管
箢	箢
箬	箬篛
箭	箭
箱	箱
箴	箴
箸	箸
節	節节
篁	篁
範	範
篆	篆
篇	篇
築	築
篋	篋箧
篌	篌
篙	篙
篚	篚
篝	篝
篡	篡
篤	篤笃
篥	篥
篦	篦
篩	篩筛
篪	篪
篳	篳筚
篷	篷
篼	篼
篾	篾
簀	簀箦
簇	簇
簋	簋
簌	簌
簍	簍篓
簏	簏
簞	簞箪
簟	簟
簡	簡简
簣	簣篑
簦	簦
簧	簧
簪	簪
簫	簫箫
簸	簸
簽	簽签
簾	簾
簿	簿
籀	籀
籃	籃篮
籌	籌筹
籍	籍
籜	籜箨
籟	籟籁
籠	籠笼
籤	籤
籩	籩笾
籪	籪簖
籬	籬篱
籮	籮箩
籲	籲龥
米	米
籼	秈籼
籽	籽
粉	粉
粑	粑
粒	粒
粕	粕
粗	粗
粘	粘
粞	粞
粟	粟
粢	粢
粤	粵粤
粥	粥
粱	粱
粲	粲
粳	粳
粹	粹
粼	粼
粽	糉粽
精	精
糅	糅
糇	餱糇
糈	糈
糊	糊
糌	糌
糍	餈糍
糕	糕
糖	糖
糗	糗
糙	糙
糜	糜
糝	糝糁
糞	糞粪
糟	糟
糠	糠
糧	糧粮
糨	糨
糯	糯
糰	糰
糲	糲粝
糴	糴籴
糶	糶粜
糸	糸
糹	糹纟
系	系
糾	糾纠
紀	紀纪
紂	紂纣
約	約约
紅	紅红
紆	紆纡
紇	紇纥
紈	紈纨
紉	紉纫
紊	紊
紋	紋纹
納	納纳
紐	紐纽
紓	紓纾
純	純纯
紕	紕纰
紗	紗纱
紙	紙纸
級	級级
紛	紛纷
紜	紜纭
素	素
紡	紡纺
索	索
紫	紫
累	累
細	細细
紱	紱绂
紲	紲绁
紳	紳绅
紹	紹绍
紺	紺绀
紼	紼绋
紿	紿绐
絀	絀绌
終	終终
組	組组
絆	絆绊
絎	絎绗
結	結结
絝	絝绔
絞	絞绞
絡	絡络
絢	絢绚
給	給给
絨	絨绒
絮	絮
統	統统
絲	絲丝
絳	絳绛
絶	絕绝絶
絹	絹绢
綁	綁绑
綃	綃绡
綆	綆绠
綈	綈绨
綉	繡绣綉
綏	綏绥
經	經经
綜	綜综
綞	綞缍
綢	綢绸
綣	綣绻
綦	綦
綫	綫線线缐
綬	綬绶
維	維维
綮	綮
綰	綰绾
綱	綱纲
網	網网
綳	綳繃绷
綴	綴缀
綸	綸纶
綹	綹绺
綺	綺绮
綻	綻绽
綽	綽绰
綾	綾绫
綿	綿绵
緄	緄绲
緇	緇缁
緊	緊紧
緋	緋绯
緑	綠绿緑
緒	緒绪
緔	緔绱
緗	緗缃
緘	緘缄
緙	緙缂
緝	緝缉
緞	緞缎
締	締缔
緡	緡缗
緣	緣缘
緦	緦缌
編	編编
緩	緩缓
緬	緬缅
緯	緯纬
緱	緱缑
緲	緲缈
練	練练
緶	緶缏
緹	緹缇
緻	緻
縈	縈萦
縉	縉缙
縊	縊缢
縋	縋缒
縐	縐绉
縑	縑缣
縛	縛缚
縝	縝缜
縞	縞缟
縟	縟缛
縣	縣县
縧	絛绦縧
縫	縫缝
縭	縭缡
縮	縮缩
縱	縱纵
縲	縲缧
縴	縴
縵	縵缦
縶	縶絷
縷	縷缕
縹	縹缥
縻	縻
總	總总
績	績绩
繁	繁
繅	繅缫
繆	繆缪
繇	繇
繒	繒缯
織	織织
繕	繕缮
繚	繚缭
繞	繞绕
繢	繢缋
繩	繩绳
繪	繪绘
繫	繫
繭	繭茧
繮	繮缰韁
繯	繯缳
繰	繰缲
繳	繳缴
繹	繹绎
繼	繼继
繽	繽缤
繾	繾缱
纂	纂
纈	纈缬
纊	纊纩
續	續续
纍	纍
纏	纏缠
纓	纓缨
纔	纔
纖	纖纤
纘	纘缵
纛	纛
纜	纜缆
缶	缶
缸	缸
缺	缺
罄	罄
罅	罅
罌	罌罂
罎	罎罈
罐	罐
罔	罔
罕	罕
罘	罘
罟	罟
罡	罡
罨	罨
罩	罩
罪	罪
置	置
罰	罰罚
罱	罱
署	署
罷	罷罢
罹	罹
罾	罾
羅	羅罗
羆	羆罴
羈	羈羁
羊	羊
羌	羌
美	美
羔	羔
羚	羚
羝	羝
羞	羞
羡	羨羡
群	羣群
羥	羥羟
羧	羧
義	義义
羯	羯
羰	羰
羲	羲
羸	羸
羹	羹
羼	羼
羽	羽
羿	羿
翁	翁
翅	翅
翊	翊
翌	翌
翎	翎
習	習习
翔	翔
翕	翕
翟	翟
翠	翠
翡	翡
翥	翥
翦	翦
翩	翩
翮	翮
翰	翰
翱	翱
翳	翳
翹	翹翘
翻	翻
翼	翼
耀	耀
老	老
考	考
耄	耄
者	者
耆	耆
耋	耋
而	而
耍	耍
耐	耐
耒	耒
耔	耔
耕	耕
耖	耖
耗	耗
耘	耘
耙	耙
耜	耜
耠	耠
耥	耥
耦	耦
耨	耨
耩	耩
耪	耪
耬	耬耧
耮	耮耢
耱	耱
耳	耳
耵	耵
耶	耶
耷	耷
耻	恥耻
耽	耽
耿	耿
聃	聃
聆	聆
聊	聊
聒	聒
聖	聖圣
聘	聘
聚	聚
聞	聞闻
聯	聯联
聰	聰聪
聱	聱
聲	聲声
聳	聳耸
聵	聵聩
聶	聶聂
職	職职
聹	聹聍
聽	聽听
聾	聾聋
聿	聿
肀	肀
肄	肄
肅	肅肃
肆	肆
肇	肇
肉	肉
肋	肋
肌	肌
肓	肓
肖	肖
肘	肘
肚	肚
肛	肛
肜	肜
肝	肝
肟	肟
股	股
肢	肢
肥	肥
肩	肩
肪	肪
肫	肫
肭	肭
肯	肯
肱	肱
育	育
肴	餚肴
肷	肷
肺	肺
肼	肼
肽	肽
胂	胂
胃	胃
胄	胄冑
背	背
胍	胍
胎	胎
胖	胖
胗	胗
胙	胙
胚	胚
胛	胛
胝	胝
胞	胞
胡	胡
胤	胤
胥	胥
胩	胩
胬	胬
胭	胭
胯	胯
胰	胰
胱	胱
胲	胲
胳	胳
胴	胴
胸	胸
胺	胺
胼	胼
能	能
脂	脂
脅	脅胁
脆	脆
脉	脈脉
脊	脊
脎	脎
脒	脒
脖	脖
脘	脘
脚	腳脚
脛	脛胫
脞	脞
脬	脬
脯	脯
脱	脫脱
脲	脲
脹	脹胀
脾	脾
腆	腆
腈	腈
腊	腊
腋	腋
腌	腌醃
腎	腎肾
腐	腐
腑	腑
腓	腓
腔	腔
腕	腕
腖	腖胨
腙	腙
腚	腚
腠	腠
腡	腡脶
腥	腥
腦	腦脑
腧	腧
腩	腩
腫	腫肿
腭	齶腭
腮	腮
腰	腰
腱	腱
腴	腴
腸	腸肠
腹	腹
腺	腺
腼	靦腼
腽	膃腽
腿	腿
膀	膀
膂	膂
膈	膈
膊	膊
膏	膏
膘	膘
膚	膚肤
膛	膛
膜	膜
膝	膝
膠	膠胶
膣	膣
膦	膦
膨	膨
膩	膩腻
膪	膪
膳	膳
膺	膺
膻	膻羶
膽	膽胆
膾	膾脍
膿	膿脓
臀	臀
臁	臁
臂	臂
臃	臃
臆	臆
臉	臉脸
臊	臊
臌	臌
臍	臍脐
臏	臏膑
臘	臘
臚	臚胪
臟	臟脏
臠	臠脔
臣	臣
臧	臧
臨	臨临
自	自
臬	臬
臭	臭
至	至
致	致
臺	臺
臻	臻
臼	臼
臾	臾
舀	舀
舁	舁
舂	舂
舄	舄
舅	舅
與	與与
興	興兴
舉	舉举
舊	舊旧
舌	舌
舍	舍
舐	舐
舒	舒
舔	舔
舛	舛
舜	舜
舞	舞
舟	舟
舡	舡
舢	舢
舨	舨
航	航
舫	舫
般	般
舭	舭
舯	舯
舳	舳
舴	舴
舵	舵
舶	舶
舷	舷
舸	舸
船	船
舾	舾
艄	艄
艇	艇
艉	艉
艋	艋
艏	艏
艘	艘
艙	艙舱
艚	艚
艟	艟
艤	艤舣
艦	艦舰
艨	艨
艫	艫舻
艮	艮
良	良
艱	艱艰
色	色
艴	艴
艷	艷艳豔
艹	艹
艽	艽
艾	艾
艿	艿
芄	芄
芈	羋芈
芊	芊
芋	芋
芍	芍
芎	芎
芏	芏
芑	芑
芒	芒
芘	芘
芙	芙
芝	芝
芟	芟
芡	芡
芤	芤
芥	芥
芨	芨
芩	芩
芪	芪
芫	芫
芬	芬
芭	芭
芮	芮
芯	芯
芰	芰
花	花
芳	芳
芴	芴
芷	芷
芹	芹
芻	芻刍
芽	芽
芾	芾
苄	苄
苊	苊
苑	苑
苒	苒
苓	苓
苔	苔
苕	苕
苗	苗
苘	苘
苛	苛
苜	苜
苞	苞
苟	苟
苠	苠
苡	苡
苣	苣
苤	苤
若	若
苦	苦
苧	苧苎
苫	苫
苯	苯
英	英
苴	苴
苷	苷
苹	苹
苻	苻
茁	茁
茂	茂
范	范
茄	茄
茅	茅
茆	茆
茇	茇
茈	茈
茉	茉
茌	茌
茗	茗
茚	茚
茛	茛
茜	茜
茨	茨
茫	茫
茬	茬
茭	茭
茯	茯
茱	茱
茳	茳
茴	茴
茵	茵
茶	茶
茸	茸
茹	茹
茺	茺
茼	茼
荀	荀
荃	荃
荆	荊荆
荇	荇
草	草
荏	荏
荐	荐
荑	荑
荒	荒
荔	荔
荷	荷
荸	荸
荻	荻
荼	荼
荽	荽
莅	蒞莅
莆	莆
莉	莉
莊	莊庄
莎	莎
莒	莒
莓	莓
莖	莖茎
莘	莘
莛	莛
莜	莜
莞	莞
莠	莠
莢	莢荚
莧	莧苋
莨	莨
莩	莩
莪	莪
莫	莫
莰	莰
莽	莽
菀	菀
菁	菁
菅	菅
菇	菇
菊	菊
菌	菌
菏	菏
菔	菔
菖	菖
菘	菘
菜	菜
菝	菝
菟	菟
菠	菠
菡	菡
菥	菥
菩	菩
菪	菪
華	華华
菰	菰
菱	菱
菲	菲
菸	菸
菹	菹
菽	菽
萁	萁
萃	萃
萄	萄
萆	萆
萇	萇苌
萊	萊莱
萋	萋
萌	萌
萍	萍
萎	萎
萏	萏
萑	萑
萘	萘
萜	萜
萬	萬
萱	萱
萵	萵莴
萸	萸
萼	萼
落	落
葆	葆
葉	葉
葑	葑
葒	葒荭
著	著
葙	葙
葚	葚
葛	葛
葜	葜
葡	葡
董	董
葤	葤荮
葦	葦苇
葩	葩
葫	葫
葬	葬
葭	葭
葯	葯药
葱	蔥葱
葳	葳
葵	葵
葶	葶
葷	葷荤
葸	葸
葺	葺
蒂	蒂
蒈	蒈
蒎	蒎
蒓	蒓莼
蒔	蒔莳
蒗	蒗
蒙	蒙
蒜	蒜
蒡	蒡
蒯	蒯
蒲	蒲
蒴	蒴
蒸	蒸
蒹	蒹
蒺	蒺
蒼	蒼苍
蒽	蒽
蒿	蒿
蓀	蓀荪
蓁	蓁
蓄	蓄
蓉	蓉
蓊	蓊
蓋	蓋盖
蓍	蓍
蓐	蓐
蓑	蓑簑
蓓	蓓
蓖	蓖
蓬	蓬
蓮	蓮莲
蓯	蓯苁
蓰	蓰
蓼	蓼
蓽	蓽荜
蓿	蓿
蔌	蔌
蔑	蔑
蔓	蔓
蔔	蔔
蔗	蔗
蔚	蔚
蔞	蔞蒌
蔟	蔟
蔡	蔡
蔣	蔣蒋
蔦	蔦茑
蔫	蔫
蔬	蔬
蔭	蔭荫
蔸	蔸
蔻	蔻
蔽	蔽
蕁	蕁荨
蕃	蕃
蕆	蕆蒇
蕈	蕈
蕉	蕉
蕊	蕊
蕎	蕎荞
蕒	蕒荬
蕓	蕓芸
蕕	蕕莸
蕖	蕖
蕘	蕘荛
蕙	蕙
蕞	蕞
蕢	蕢蒉
蕤	蕤
蕨	蕨
蕩	蕩荡盪
蕪	蕪芜
蕭	蕭萧
蕷	蕷蓣
蕹	蕹
蕺	蕺
蕻	蕻
蕾	蕾
薄	薄
薅	薅
薇	薇
薈	薈荟
薊	薊蓟
薌	薌芗
薏	薏
薑	薑
薔	薔蔷
薛	薛
薜	薜
薟	薟莶
薤	薤
薦	薦
薨	薨
薩	薩萨
薪	薪
薯	薯
薰	薰
薷	薷
薹	薹
薺	薺荠
藁	藁
藉	藉
藍	藍蓝
藎	藎荩
藏	藏
藐	藐
藕	藕
藜	藜
藝	藝艺
藤	藤籐
藥	藥
藩	藩
藪	藪薮
藴	蘊蕴藴
藶	藶苈
藹	藹蔼
藺	藺蔺
藻	藻
藿	藿
蘄	蘄蕲
蘅	蘅
蘆	蘆芦
蘇	蘇苏甦
蘋	蘋
蘑	蘑
蘖	櫱蘖
蘚	蘚藓
蘞	蘞蔹
蘢	蘢茏
蘧	蘧
蘩	蘩
蘭	蘭兰
蘸	蘸
蘺	蘺蓠
蘼	蘼
蘿	蘿萝
虍	虍
虎	虎
虐	虐
虔	虔
處	處处
虚	虛虚
虜	虜虏
虞	虞
號	號号
虢	虢
虧	虧亏
虬	虯虬
虱	蝨虱
虹	虹
虺	虺
虻	虻
虼	虼
蚊	蚊
蚋	蚋
蚌	蚌
蚍	蚍
蚓	蚓
蚜	蚜
蚝	蚝蠔
蚣	蚣
蚤	蚤
蚧	蚧
蚨	蚨
蚩	蚩
蚪	蚪
蚯	蚯
蚰	蚰
蚱	蚱
蚴	蚴
蚵	蚵
蚶	蚶
蚺	蚺
蛀	蛀
蛄	蛄
蛆	蛆
蛇	蛇
蛉	蛉
蛋	蛋
蛐	蛐
蛑	蛑
蛔	蛔
蛘	蛘
蛙	蛙
蛛	蛛
蛞	蛞
蛟	蛟
蛤	蛤
蛩	蛩
蛭	蛭
蛸	蛸
蛹	蛹
蛺	蛺蛱
蛾	蛾
蜀	蜀
蜂	蜂
蜃	蜃
蜆	蜆蚬
蜇	蜇
蜈	蜈
蜉	蜉
蜊	蜊
蜍	蜍
蜒	蜒
蜓	蜓
蜕	蛻蜕
蜘	蜘
蜚	蜚
蜜	蜜
蜞	蜞
蜡	蜡
蜢	蜢
蜣	蜣
蜥	蜥
蜩	蜩
蜮	蜮
蜱	蜱
蜴	蜴
蜷	蜷
蜻	蜻
蜾	蜾
蜿	蜿
蝌	蝌
蝎	蝎蠍
蝓	蝓
蝕	蝕蚀
蝗	蝗
蝙	蝙
蝠	蝠
蝣	蝣
蝤	蝤
蝥	蝥
蝦	蝦虾
蝮	蝮
蝰	蝰
蝴	蝴
蝶	蝶
蝸	蝸蜗
蝻	蝻
蝽	蝽
螂	螂
螃	螃
螄	螄蛳
螅	螅
螈	螈
螋	螋
融	融
螓	螓
螗	螗
螞	螞蚂
螟	螟
螢	螢萤
螫	螫
螬	螬
螭	螭
螯	螯
螳	螳
螵	螵
螺	螺
螻	螻蝼
螽	螽
蟀	蟀
蟄	蟄蛰
蟆	蟆
蟈	蟈蝈
蟊	蟊
蟋	蟋
蟎	蟎螨
蟑	蟑
蟒	蟒
蟓	蟓
蟛	蟛
蟠	蟠
蟣	蟣虮
蟥	蟥
蟪	蟪
蟬	蟬蝉
蟮	蟮
蟯	蟯蛲
蟲	蟲虫
蟶	蟶蛏
蟹	蟹
蟻	蟻蚁
蟾	蟾
蠃	蠃
蠅	蠅蝇
蠆	蠆虿
蠊	蠊
蠐	蠐蛴
蠑	蠑蝾
蠓	蠓
蠕	蠕
蠖	蠖
蠛	蠛
蠟	蠟
蠡	蠡
蠢	蠢
蠣	蠣蛎
蠱	蠱蛊
蠲	蠲
蠶	蠶蚕
蠹	蠹
蠻	蠻蛮
蠼	蠼
血	血
衄	衄
衆	衆众眾
衊	衊
行	行
衍	衍
術	術
街	街
衙	衙
衛	衛卫
衝	衝
衡	衡
衢	衢
衣	衣
衤	衤
表	表
衩	衩
衫	衫
衮	袞衮
衰	衰
衲	衲
衷	衷
衹	衹
衽	衽
衾	衾
衿	衿
袁	袁
袂	袂
袈	袈
袋	袋
袍	袍
袒	袒
袖	袖
袢	袢
袤	袤
被	被
袱	袱
袷	袷
袼	袼
裁	裁
裂	裂
裉	裉
裊	裊嬝袅
裎	裎
裏	裏裡
裒	裒
裔	裔
裕	裕
裘	裘
裙	裙
補	補补
裝	裝装
裟	裟
裨	裨
裰	裰
裱	裱
裳	裳
裴	裴
裸	裸
裹	裹
裼	裼
製	製
裾	裾
褂	褂
複	複
褊	褊
褐	褐
褒	褒
褓	褓
褙	褙
褚	褚
褡	褡
褥	褥
褪	褪
褫	褫
褰	褰
褲	褲裤
褳	褳裢
褶	褶
褸	褸褛
褻	褻亵
襁	襁
襄	襄
襇	襇裥
襖	襖袄
襝	襝裣
襞	襞
襟	襟
襠	襠裆
襤	襤褴
襦	襦
襪	襪袜
襬	襬
襯	襯衬
襲	襲袭
襻	襻
西	西
要	要
覃	覃
覆	覆
見	見见
規	規规
覓	覓觅
視	視视
覘	覘觇
覡	覡觋
覦	覦觎
親	親亲
覬	覬觊
覯	覯觏
覲	覲觐
覷	覷觑
覺	覺觉
覽	覽览
覿	覿觌
觀	觀观
角	角
觖	觖
觚	觚
觜	觜
解	解
觥	觥
觫	觫
觳	觳
觴	觴觞
觶	觶觯
觸	觸触
言	言
訁	訁讠
訂	訂订
訃	訃讣
訇	訇
計	計计
訊	訊讯
訌	訌讧
討	討讨
訐	訐讦
訓	訓训
訕	訕讪
訖	訖讫
記	記记
訛	訛讹
訝	訝讶
訟	訟讼
訣	訣诀
訥	訥讷
訪	訪访
設	設设
許	許许
訴	訴诉
訶	訶诃
診	診诊
訾	訾
詁	詁诂
詆	詆诋
詈	詈
詎	詎讵
詐	詐诈
詒	詒诒
詔	詔诏
評	評评
詘	詘诎
詛	詛诅
詞	詞词
詡	詡诩
詢	詢询
詣	詣诣
試	試试
詩	詩诗
詫	詫诧
詬	詬诟
詭	詭诡
詮	詮诠
詰	詰诘
話	話话
該	該该
詳	詳详
詵	詵诜
詹	詹
詼	詼诙
詿	詿诖
誄	誄诔
誅	誅诛
誆	誆诓
誇	誇
認	認认
誑	誑诳
誒	誒诶
誓	誓
誕	誕诞
誘	誘诱
誚	誚诮
語	語语
誠	誠诚
誡	誡诫
誣	誣诬
誤	誤误
誥	誥诰
誦	誦诵
誨	誨诲
説	說说説
誰	誰谁
課	課课
誶	誶谇
誹	誹诽
誼	誼谊
調	調调
諂	諂谄
諄	諄谆
談	談谈
諉	諉诿
請	請请
諍	諍诤
諏	諏诹
諑	諑诼
諒	諒谅
論	論论
諗	諗谂
諛	諛谀
諜	諜谍
諞	諞谝
諢	諢诨
諤	諤谔
諦	諦谛
諧	諧谐
諫	諫谏
諭	諭谕
諮	諮谘
諱	諱讳
諳	諳谙
諶	諶谌
諷	諷讽
諸	諸诸
諺	諺谚
諼	諼谖
諾	諾诺
謀	謀谋
謁	謁谒
謂	謂谓
謄	謄誊
謅	謅诌
謇	謇
謊	謊谎
謎	謎谜
謐	謐谧
謔	謔谑
謖	謖谡
謗	謗谤
謙	謙谦
謚	謚諡谥
講	講讲
謝	謝谢
謡	謠谣謡
謦	謦
謨	謨谟
謫	謫谪
謬	謬谬
謭	譾谫謭
謳	謳讴
謹	謹谨
謾	謾谩
證	證证証
譎	譎谲
譏	譏讥
譖	譖谮
識	識识
譙	譙谯
譚	譚谭
譜	譜谱
警	警
譫	譫谵
譬	譬
譯	譯译
議	議议
譴	譴谴
護	護护
譽	譽誉
讀	讀读
變	變变
讎	讎雠
讒	讒谗
讓	讓让
讕	讕谰
讖	讖谶
讜	讜谠
讞	讞谳
谷	谷
豁	豁
豆	豆
豇	豇
豈	豈岂
豉	豉
豌	豌
豐	豐
豕	豕
豚	豚
象	象
豢	豢
豪	豪
豫	豫
豳	豳
豸	豸
豹	豹
豺	豺
貂	貂
貅	貅
貉	貉
貊	貊
貌	貌
貔	貔
貘	貘
貝	貝贝
貞	貞贞
負	負负
財	財财
貢	貢贡
貧	貧贫
貨	貨货
販	販贩
貪	貪贪
貫	貫贯
責	責责
貯	貯贮
貰	貰贳
貲	貲赀
貳	貳贰
貴	貴贵
貶	貶贬
買	買买
貸	貸贷
貺	貺贶
費	費费
貼	貼贴
貽	貽贻
貿	貿贸
賀	賀贺
賁	賁贲
賂	賂赂
賃	賃赁
賄	賄贿
賅	賅赅
資	資资
賈	賈贾
賊	賊贼
賑	賑赈
賒	賒赊
賓	賓宾
賕	賕赇
賚	賚赉
賜	賜赐
賞	賞赏
賠	賠赔
賡	賡赓
賢	賢贤
賣	賣卖
賤	賤贱
賦	賦赋
賧	賧赕
質	質质
賫	齎赍賫
賬	賬账
賭	賭赌
賴	賴赖
賺	賺赚
賻	賻赙
購	購购
賽	賽赛
賾	賾赜
贄	贄贽
贅	贅赘
贈	贈赠
贊	贊赞讚
贋	贋赝贗
贍	贍赡
贏	贏赢
贐	贐赆
贖	贖赎
贛	贛赣
贜	贓赃贜
赤	赤
赦	赦
赧	赧
赫	赫
赭	赭
走	走
赳	赳
赴	赴
起	起
趁	趁
趄	趄
超	超
越	越
趑	趑
趔	趔
趕	趕赶
趙	趙赵
趟	趟
趣	趣
趨	趨趋
趲	趲趱
足	足
趴	趴
趵	趵
趺	趺
趼	趼
趾	趾
趿	趿
跆	跆
跋	跋
跌	跌
跎	跎
跏	跏
跑	跑
跖	跖
跗	跗
跚	跚
跛	跛
距	距
跟	跟
跣	跣
跤	跤
跨	跨
跪	跪
跫	跫
跬	跬
路	路
跳	跳
跺	跺
跽	跽
踅	踅
踉	踉
踏	踏
踐	踐践
踔	踔
踝	踝
踞	踞
踟	踟
踢	踢
踣	踣
踩	踩
踪	蹤踪
踮	踮
踱	踱
踴	踴踊
踵	踵
踹	踹
踺	踺
踽	踽
蹀	蹀
蹁	蹁
蹂	蹂
蹄	蹄
蹇	蹇
蹈	蹈
蹉	蹉
蹊	蹊
蹋	蹋
蹌	蹌跄
蹕	蹕跸
蹙	蹙
蹣	蹣蹒
蹦	蹦
蹩	蹩
蹬	蹬
蹭	蹭
蹯	蹯
蹰	躕蹰
蹲	蹲
蹴	蹴
蹶	蹶
蹺	蹺跷
蹼	蹼
躁	躁
躅	躅
躇	躇
躉	躉趸
躊	躊踌
躋	躋跻
躍	躍跃
躐	躐
躑	躑踯
躒	躒跞
躓	躓踬
躔	躔
躚	躚跹
躞	躞
躡	躡蹑
躥	躥蹿
躦	躦躜
躪	躪躏
身	身
躬	躬
躲	躲
躺	躺
軀	軀躯
車	車车
軋	軋轧
軌	軌轨
軍	軍军
軎	軎
軒	軒轩
軔	軔轫
軛	軛轭
軟	軟软
軤	軤轷
軫	軫轸
軲	軲轱
軸	軸轴
軹	軹轵
軺	軺轺
軻	軻轲
軼	軼轶
軾	軾轼
較	較较
輅	輅辂
輇	輇辁
載	載载
輊	輊轾
輒	輒辄
輔	輔辅
輕	輕轻
輛	輛辆
輜	輜辎
輝	輝辉
輞	輞辋
輟	輟辍
輥	輥辊
輦	輦辇
輩	輩辈
輪	輪轮
輯	輯辑
輳	輳辏
輸	輸输
輻	輻辐
輾	輾辗
輿	輿舆
轂	轂毂
轄	轄辖
轅	轅辕
轆	轆辘
轉	轉转
轍	轍辙
轎	轎轿
轔	轔辚
轟	轟轰
轡	轡辔
轢	轢轹
轤	轤轳
辛	辛
辜	辜
辟	辟
辣	辣
辦	辦办
辨	辨
辭	辭辞
辮	辮辫
辯	辯辩
辰	辰
辱	辱
農	農农
辶	辶
迂	迂
迄	迄
迅	迅
迎	迎
近	近
迓	迓
返	返
迕	迕
迢	迢
迤	迤迆
迥	迥
迦	迦
迨	迨
迪	迪
迫	迫
迭	迭
迮	迮
述	述
迴	迴廻
迷	迷
迸	迸
迹	跡迹蹟
追	追
退	退
送	送
逃	逃
逄	逄
逅	逅
逆	逆
逋	逋
逍	逍
透	透
逐	逐
逑	逑
途	途
逕	逕迳
逖	逖
逗	逗
這	這这
通	通
逛	逛
逝	逝
逞	逞
速	速
造	造
逡	逡
逢	逢
連	連连
逭	逭
逮	逮
逯	逯
進	進进
逵	逵
逶	逶
逸	逸
逼	逼
逾	逾
遁	遁
遂	遂
遄	遄
遇	遇
運	運运
遍	遍
過	過过
遏	遏
遐	遐
遑	遑
遒	遒
道	道
達	達达躂跶
違	違违
遘	遘
遛	遛
遜	遜逊
遞	遞递
遠	遠远
遢	遢
遣	遣
遥	遙遥
遨	遨
適	適适
遭	遭
遮	遮
遲	遲迟
遴	遴
遵	遵
遷	遷迁
選	選选
遺	遺遗
遼	遼辽
遽	遽
避	避
邀	邀
邁	邁迈
邂	邂
邃	邃
還	還还
邇	邇迩
邈	邈
邊	邊边
邋	邋
邏	邏逻
邐	邐逦
邑	邑
邕	邕
邗	邗
邙	邙
邛	邛
邡	邡
邢	邢
那	那
邦	邦
邪	邪
邯	邯
邰	邰
邱	邱
邳	邳
邴	邴
邵	邵
邶	邶
邸	邸
邾	邾
郁	郁
郄	郄
郅	郅
郇	郇
郊	郊
郎	郎
郗	郗
郛	郛
郜	郜
郝	郝
郟	郟郏
郡	郡
郢	郢
部	部
郫	郫
郭	郭
郯	郯
郴	郴
郵	郵邮
都	都
郾	郾
鄂	鄂
鄄	鄄
鄆	鄆郓
鄉	鄉乡
鄒	鄒邹
鄔	鄔邬
鄖	鄖郧
鄙	鄙
鄞	鄞
鄢	鄢
鄣	鄣
鄧	鄧邓
鄭	鄭郑
鄯	鄯
鄰	鄰邻
鄱	鄱
鄲	鄲郸
鄴	鄴邺
鄶	鄶郐
鄹	鄹
鄺	鄺邝
酃	酃
酆	酆
酈	酈郦
酉	酉
酊	酊
酋	酋
酌	酌
配	配
酎	酎
酏	酏
酐	酐
酒	酒
酗	酗
酚	酚
酞	酞
酡	酡
酢	酢
酣	酣
酤	酤
酥	酥
酩	酩
酪	酪
酬	酬
酮	酮
酯	酯
酰	酰
酲	酲
酴	酴
酵	酵
酶	酶
酷	酷
酸	酸
酹	酹
醅	醅
醇	醇
醉	醉
醋	醋
醌	醌
醍	醍
醐	醐
醑	醑
醒	醒
醖	醞酝醖
醚	醚
醛	醛
醜	醜
醢	醢
醣	醣
醪	醪
醫	醫医
醬	醬酱
醭	醭
醮	醮
醯	醯
醴	醴
醵	醵
醺	醺
釀	釀酿
釁	釁衅
釃	釃酾
釅	釅酽
采	采採
釉	釉
釋	釋释
里	里
重	重
野	野
量	量
金	金
釒	釒钅
釓	釓钆
釔	釔钇
釕	釕钌
釗	釗钊
釘	釘钉
釙	釙钋
釜	釜
針	針针
釣	釣钓
釤	釤钐
釧	釧钏
釩	釩钒
釵	釵钗
釷	釷钍
釹	釹钕
釺	釺钎
鈀	鈀钯
鈁	鈁钫
鈄	鈄钭
鈈	鈈钚
鈉	鈉钠
鈍	鈍钝
鈎	鉤钩鈎
鈐	鈐钤
鈑	鈑钣
鈔	鈔钞
鈕	鈕钮
鈞	鈞钧
鈣	鈣钙
鈥	鈥钬
鈦	鈦钛
鈧	鈧钪
鈮	鈮铌
鈰	鈰铈
鈳	鈳钶
鈴	鈴铃
鈷	鈷钴
鈸	鈸钹
鈹	鈹铍
鈺	鈺钰
鈽	鈽钸
鈾	鈾铀
鈿	鈿钿
鉀	鉀钾
鉅	鉅钜
鉈	鉈铊
鉉	鉉铉
鉍	鉍铋
鉑	鉑铂
鉕	鉕钷
鉗	鉗钳
鉚	鉚铆
鉛	鉛铅
鉞	鉞钺
鉢	鉢钵缽
鉦	鉦钲
鉬	鉬钼
鉭	鉭钽
鉸	鉸铰
鉺	鉺铒
鉻	鉻铬
鉿	鉿铪
銀	銀银
銃	銃铳
銅	銅铜
銎	銎
銑	銑铣
銓	銓铨
銖	銖铢
銘	銘铭
銚	銚铫
銜	銜啣衔
銠	銠铑
銣	銣铷
銥	銥铱
銦	銦铟
銨	銨铵
銩	銩铥
銪	銪铕
銫	銫铯
銬	銬铐
銱	銱铞
銷	銷销
銹	鏽锈銹
銻	銻锑
銼	銼锉
鋁	鋁铝
鋃	鋃锒
鋅	鋅锌
鋇	鋇钡
鋈	鋈
鋌	鋌铤
鋏	鋏铗
鋒	鋒锋
鋝	鋝锊
鋟	鋟锓
鋣	鋣铘
鋤	鋤锄
鋥	鋥锃
鋦	鋦锔
鋨	鋨锇
鋪	鋪铺
鋭	銳锐鋭
鋮	鋮铖
鋯	鋯锆
鋰	鋰锂
鋱	鋱铽
鋶	鋶锍
鋸	鋸锯
鋼	鋼钢
錁	錁锞
錆	錆锖
錇	錇锫
錈	錈锩
錐	錐锥
錒	錒锕
錕	錕锟
錘	錘锤
錙	錙锱
錚	錚铮
錛	錛锛
錟	錟锬
錠	錠锭
錢	錢钱
錦	錦锦
錨	錨锚
錫	錫锡
錮	錮锢
錯	錯错
録	錄录録
錳	錳锰
錶	錶
錸	錸铼
鍀	鍀锝
鍁	鍁锨
鍃	鍃锪
鍆	鍆钔
鍇	鍇锴
鍋	鍋锅
鍍	鍍镀
鍔	鍔锷
鍘	鍘铡
鍛	鍛锻
鍤	鍤锸
鍥	鍥锲
鍩	鍩锘
鍪	鍪
鍬	鍬锹
鍰	鍰锾
鍵	鍵键
鍶	鍶锶
鍺	鍺锗
鍾	鍾锺
鎂	鎂镁
鎄	鎄锿
鎇	鎇镅
鎊	鎊镑
鎏	鎏
鎖	鎖锁
鎘	鎘镉
鎢	鎢钨
鎣	鎣蓥
鎦	鎦镏
鎧	鎧铠
鎩	鎩铩
鎪	鎪锼
鎬	鎬镐
鎮	鎮镇
鎰	鎰镒
鎳	鎳镍
鎵	鎵镓
鎸	鐫镌鎸
鎿	鎿镎
鏃	鏃镞
鏇	鏇镟
鏈	鏈链
鏊	鏊
鏌	鏌镆
鏍	鏍镙
鏑	鏑镝
鏖	鏖
鏗	鏗铿
鏘	鏘锵
鏜	鏜镗
鏝	鏝镘
鏞	鏞镛
鏟	鏟剷铲
鏡	鏡镜
鏢	鏢镖
鏤	鏤镂
鏨	鏨錾
鏵	鏵铧
鏷	鏷镤
鏹	鏹镪
鐃	鐃铙
鐋	鐋铴
鐐	鐐镣
鐒	鐒铹
鐓	鐓镦
鐔	鐔镡
鐘	鐘钟
鐙	鐙镫
鐝	鐝镢
鐠	鐠镨
鐦	鐦锎
鐧	鐧锏
鐨	鐨镄
鐮	鐮镰
鐲	鐲镯
鐳	鐳镭
鐵	鐵铁
鐸	鐸铎
鐺	鐺铛
鐾	鐾
鐿	鐿镱
鑄	鑄铸
鑊	鑊镬
鑌	鑌镔
鑒	鑒鉴鑑鍳
鑔	鑔镲
鑠	鑠铄
鑣	鑣镳
鑥	鑥镥
鑫	鑫
鑭	鑭镧
鑰	鑰钥
鑲	鑲镶
鑷	鑷镊
鑹	鑹镩
鑼	鑼锣
鑽	鑽钻
鑾	鑾銮
鑿	鑿凿
長	長长
門	門门
閂	閂闩
閃	閃闪
閆	閆闫
閉	閉闭
開	開开
閌	閌闶
閎	閎闳
閏	閏闰
閑	閑闲閒
間	間间
閔	閔闵
閘	閘闸
閡	閡阂
閣	閣阁
閤	閤
閥	閥阀
閨	閨闺
閩	閩闽
閫	閫阃
閬	閬阆
閭	閭闾
閲	閱阅閲
閶	閶阊
閹	閹阉
閻	閻阎
閼	閼阏
閽	閽阍
閾	閾阈
閿	閿阌
闃	闃阒
闆	闆
闈	闈闱
闊	闊阔
闋	闋阕
闌	闌阑
闐	闐阗
闔	闔阖
闕	闕阙
闖	闖闯
關	關关
闞	闞阚
闡	闡阐
闢	闢
闥	闥闼
阜	阜
阝	阝
阡	阡
阢	阢
阪	阪
阮	阮
阱	阱
防	防
阻	阻
阼	阼
阽	阽
阿	阿
陀	陀
陂	陂
附	附
陋	陋
陌	陌
降	降
限	限
陔	陔
陘	陘陉
陛	陛
陝	陝陕
陟	陟
陡	陡
院	院
陣	陣阵
除	除
陧	隉陧
陪	陪
陬	陬
陰	陰阴
陲	陲
陳	陳陈
陴	陴
陵	陵
陶	陶
陷	陷
陸	陸陆
陽	陽阳
隅	隅
隆	隆
隈	隈
隊	隊队
隋	隋
隍	隍
階	階阶
隔	隔
隕	隕陨
隗	隗
隘	隘
隙	隙
際	際际
障	障
隧	隧
隨	隨随
險	險险
隰	隰
隱	隱隐
隳	隳
隴	隴陇
隸	隸隶隷
隹	隹
隻	隻
隼	隼
隽	雋隽
雀	雀
雁	雁
雄	雄
雅	雅
集	集
雇	僱雇
雉	雉
雌	雌
雍	雍
雎	雎
雒	雒
雕	雕彫鵰
雖	雖虽
雙	雙双
雛	雛雏
雜	雜杂
離	離离
難	難难
雨	雨
雩	雩
雪	雪
雯	雯
雲	雲
零	零
雷	雷
雹	雹
電	電电
需	需
霄	霄
霆	霆
震	震
霈	霈
霉	霉
霍	霍
霎	霎
霏	霏
霓	霓
霖	霖
霜	霜
霞	霞
霧	霧雾
霪	霪
霰	霰
露	露
霸	霸
霹	霹
霽	霽霁
霾	霾
靂	靂雳
靄	靄霭
靈	靈灵
青	青
靖	靖
静	靜静
靚	靚靓
靛	靛
非	非
靠	靠
靡	靡
面	面
靨	靨靥
革	革
靳	靳
靴	靴
靶	靶
靼	靼
鞅	鞅
鞋	鞋
鞍	鞍
鞏	鞏巩
鞔	鞔
鞘	鞘
鞠	鞠
鞣	鞣
鞦	鞦
鞫	鞫
鞭	鞭
鞲	韝鞲
鞴	鞴
鞽	鞽鞒
韃	韃鞑
韆	韆
韉	韉鞯
韋	韋韦
韌	韌韧
韓	韓韩
韙	韙韪
韜	韜韬
韞	韞韫
韭	韭
音	音
韵	韻韵
韶	韶
響	響响
頁	頁页
頂	頂顶
頃	頃顷
項	項项
順	順顺
頇	頇顸
須	須须
頊	頊顼
頌	頌颂
頎	頎颀
頏	頏颃
預	預预
頑	頑顽
頒	頒颁
頓	頓顿
頗	頗颇
領	領领
頜	頜颌
頡	頡颉
頤	頤颐
頦	頦颏
頭	頭头
頰	頰颊
頷	頷颔
頸	頸颈
頻	頻频
頽	頹颓頽
顆	顆颗
題	題题
額	額额
顎	顎颚
顓	顓颛
顔	顏颜顔
願	願
顙	顙颡
顛	顛颠
類	類类
顢	顢颟
顥	顥颢
顧	顧顾
顫	顫颤
顬	顬颥
顯	顯显
顰	顰颦
顱	顱颅
顳	顳颞
顴	顴颧
風	風风
颮	颮飑
颯	颯飒
颱	颱
颳	颳
颶	颶飓
颼	颼飕
飄	飄飘
飆	飆飙
飈	飈飚
飛	飛飞
食	食
飠	飠饣
飢	飢饥
飧	飧
飩	飩饨
飪	飪饪
飫	飫饫
飭	飭饬
飯	飯饭
飲	飲饮
飴	飴饴
飼	飼饲
飽	飽饱
飾	飾饰
餃	餃饺
餅	餅饼
餉	餉饷
養	養养
餌	餌饵
餐	餐
餑	餑饽
餒	餒馁
餓	餓饿
餘	餘馀
餛	餛馄
餞	餞饯
餡	餡馅
館	館馆
餮	餮
餳	餳饧
餷	餷馇
餼	餼饩
餾	餾馏
餿	餿馊
饃	饃馍
饅	饅馒
饈	饈馐
饉	饉馑
饊	饊馓
饋	饋馈餽
饌	饌馔
饑	饑
饒	饒饶
饔	饔
饕	饕
饗	饗飨
饜	饜餍
饞	饞馋
饢	饢馕
首	首
馗	馗
馘	馘
香	香
馥	馥
馨	馨
馬	馬马
馭	馭驭
馮	馮冯
馱	馱驮
馳	馳驰
馴	馴驯
駁	駁驳
駐	駐驻
駑	駑驽
駒	駒驹
駔	駔驵
駕	駕驾
駘	駘骀
駙	駙驸
駛	駛驶
駝	駝驼
駟	駟驷
駡	罵骂駡
駢	駢骈
駭	駭骇
駱	駱骆
駿	駿骏
騁	騁骋
騅	騅骓
騍	騍骒
騎	騎骑
騏	騏骐
騖	騖骛
騙	騙骗
騫	騫骞
騭	騭骘
騮	騮骝
騰	騰腾
騶	騶驺
騷	騷骚
騸	騸骟
騾	騾骡
驀	驀蓦
驁	驁骜
驂	驂骖
驃	驃骠
驄	驄骢
驅	驅驱
驊	驊骅
驍	驍骁
驏	驏骣
驕	驕骄
驗	驗验
驚	驚惊
驛	驛驿
驟	驟骤
驢	驢驴
驤	驤骧
驥	驥骥
驪	驪骊
骨	骨
骯	骯肮
骰	骰
骱	骱
骶	骶
骷	骷
骸	骸
骺	骺
骼	骼
髀	髀
髁	髁
髂	髂
髏	髏髅
髑	髑
髒	髒
髓	髓
體	體体
髕	髕髌
髖	髖髋
高	高
髟	髟
髡	髡
髦	髦
髫	髫
髭	髭
髮	髮
髯	髯
髹	髹
髻	髻
鬃	鬃
鬆	鬆
鬈	鬈
鬍	鬍
鬏	鬏
鬚	鬚
鬟	鬟
鬢	鬢鬓
鬣	鬣
鬥	鬥鬭鬪
鬧	鬧闹
鬩	鬩阋
鬮	鬮阄
鬯	鬯
鬱	鬱
鬲	鬲
鬻	鬻
鬼	鬼
魁	魁
魂	魂
魃	魃
魄	魄
魅	魅
魈	魈
魍	魍
魎	魎魉
魏	魏
魑	魑
魔	魔
魘	魘魇
魚	魚鱼
魯	魯鲁
魴	魴鲂
魷	魷鱿
鮁	鮁鲅
鮃	鮃鲆
鮎	鮎鲇
鮐	鮐鲐
鮑	鮑鲍
鮒	鮒鲋
鮚	鮚鲒
鮝	鯗鲞鮝
鮞	鮞鲕
鮪	鮪鲔
鮫	鮫鲛
鮭	鮭鲑
鮮	鮮鲜
鯀	鯀鲧
鯁	鯁鲠
鯇	鯇鲩
鯉	鯉鲤
鯊	鯊鲨
鯔	鯔鲻
鯖	鯖鲭
鯛	鯛鲷
鯝	鯝鲴
鯡	鯡鲱
鯢	鯢鲵
鯤	鯤鲲
鯧	鯧鲳
鯨	鯨鲸
鯪	鯪鲮
鯫	鯫鲰
鯰	鯰鲶
鯴	鯴鲺
鯽	鯽鲫
鯿	鯿鳊
鰈	鰈鲽
鰉	鰉鳇
鰍	鰍鳅
鰐	鰐鳄鱷
鰒	鰒鳆
鰓	鰓鳃
鰠	鰠鳋
鰣	鰣鲥
鰥	鰥鳏
鰨	鰨鳎
鰩	鰩鳐
鰭	鰭鳍
鰱	鰱鲢
鰲	鰲鳌鼇
鰳	鰳鳓
鰵	鰵鳘
鰷	鰷鲦
鰹	鰹鲣
鰻	鰻鳗
鰾	鰾鳔
鱅	鱅鳙
鱈	鱈鳕
鱉	鱉鳖
鱒	鱒鳟
鱔	鱔鳝
鱖	鱖鳜
鱗	鱗鳞
鱘	鱘鲟
鱝	鱝鲼
鱟	鱟鲎
鱧	鱧鳢
鱭	鱭鲚
鱸	鱸鲈
鱺	鱺鲡
鳥	鳥鸟
鳩	鳩鸠
鳧	鳬凫鳧
鳳	鳳凤
鳴	鳴鸣
鳶	鳶鸢
鴆	鴆鸩
鴇	鴇鸨
鴉	鴉鸦
鴕	鴕鸵
鴛	鴛鸳
鴝	鴝鸲
鴟	鴟鸱
鴣	鴣鸪
鴦	鴦鸯
鴨	鴨鸭
鴯	鴯鸸
鴰	鴰鸹
鴻	鴻鸿
鴿	鴿鸽
鵂	鵂鸺
鵑	鵑鹃
鵒	鵒鹆
鵓	鵓鹁
鵜	鵜鹈
鵝	鵝鹅
鵠	鵠鹄
鵡	鵡鹉
鵪	鵪鹌
鵬	鵬鹏
鵯	鵯鹎
鵲	鵲鹊
鶇	鶇鸫
鶉	鶉鹑
鶓	鶓鹋
鶘	鶘鹕
鶚	鶚鹗
鶥	鶥鹛
鶩	鶩鹜
鶯	鶯莺
鶴	鶴鹤
鶻	鶻鹘
鶼	鶼鹣
鷀	鷀鹚
鷂	鷂鹞
鷄	鷄鸡雞
鷓	鷓鹧
鷗	鷗鸥
鷙	鷙鸷
鷚	鷚鹨
鷥	鷥鸶
鷦	鷦鹪
鷯	鷯鹩
鷲	鷲鹫
鷳	鷳鹇
鷸	鷸鹬
鷹	鷹鹰
鷺	鷺鹭
鸌	鸌鹱
鸕	鸕鸬
鸚	鸚鹦
鸛	鸛鹳
鸝	鸝鹂
鸞	鸞鸾
鹵	鹵卤
鹹	鹹
鹺	鹺鹾
鹼	鹼硷礆
鹽	鹽盐
鹿	鹿
麂	麂
麇	麇
麈	麈
麋	麋
麒	麒
麓	麓
麗	麗丽
麝	麝
麟	麟
麥	麥麦
麩	麩麸
麯	麯
麴	麴麹
麵	麵麪
麻	麻痲
麽	麼麽
麾	麾
黄	黃黄
黌	黌黉
黍	黍
黎	黎
黏	黏
黑	黑
黔	黔
默	默
黛	黛
黜	黜
黝	黝
點	點点
黟	黟
黠	黠
黢	黢
黥	黥
黧	黧
黨	黨
黯	黯
黲	黲黪
黴	黴
黷	黷黩
黹	黹
黻	黻
黼	黼
黽	黽黾
黿	黿鼋
鼉	鼉鼍
鼎	鼎
鼐	鼐
鼓	鼓
鼕	鼕
鼗	鼗
鼙	鼙
鼠	鼠
鼢	鼢
鼬	鼬
鼯	鼯
鼷	鼷
鼹	鼴鼹
鼻	鼻
鼽	鼽
鼾	鼾
齄	齄
齊	齊齐
齋	齋斋
齏	齏齑
齒	齒齿
齔	齔龀
齙	齙龅
齜	齜龇
齟	齟龃
齠	齠龆
齡	齡龄
齣	齣
齦	齦龈
齪	齪龊
齬	齬龉
齲	齲龋
齷	齷龌
龍	龍龙
龐	龐庞厖
龔	龔龚
龕	龕龛
龜	龜龟
龠	龠