[⿰⿳业丷臿殳]	鑿
[⿰〢⿱𠂉丶]	鉴
[⿰〢又]	坚悭铿鲣紧肾贤
[⿰丬夕]	奖桨浆酱
[⿰户攵]	啓啟綮
[⿰歺又]	餐
[⿰育攵]	徹撤澈轍辙
[⿰贝贝]	罂
[⿱⺌貝]	嗩瑣鎖
[⿱⺌贝]	唢琐锁
[⿱⿰幺幺丱]	關
[⿱ス工]	刭劲弪径氢泾烃痉经羟胫茎轻迳陉颈
[⿱亠⿲丶⿰丨丨丶]	变娈孪峦弯湾恋挛栾滦脔蛮銮鸾
[⿱免冫]	搀谗馋
[⿱冃羽]	塌榻溻蹋遢鰨鳎
[⿱刀巴]	絶脆
[⿱又⿻丨二]	峄怿择箨泽绎译释铎驿
[⿱吂䏎1]	嬴瀛贏赢
[⿱囘又]	歿沒
[⿱巛夕]	拶
[⿱左肉]	惰
[⿱必皿]	謐谧
[⿱爫缶]	摇瑶謡谣遥鳐鹞
[⿱肉缶]	搖瑤謠遙
[⿱至用]	備憊鞴
[⿱臼工]	隉
[⿱艹冖1]	茔茕荥荧莹滢莺萤营萦蓥
[⿱艹冖2]	荦
[⿱𠂉⿹𠄎⿰丿丿]	殇觞
[⿱𠂉昜]	傷殤觴
[⿱𭕄冖]	喾学泶觉搅鲎
[⿳囟八夊]	傻
[⿳宀⿻龷一八2]	搴褰謇蹇騫骞
[⿳宀⿻龷一八]	塞噻寨賽赛
[⿳小日小]	隙
[⿳艹罒儿]	甍薨
[⿳𫜹冖又]	寝寢鋟锓
[⿷匚⿳丨口丨]	姬頤颐
[⿷匚夹]	惬箧
[⿹𠄎⿰丿丿]	场扬杨汤烫荡铴炀畅疡砀肠飏饧
[⿻⿻𠃋一⿻𠃌八]	拣炼练
[㬎]	顯
[不1]	坏怀
[不2]	环还
[井]	耕
[亘]	恒
[亦]	跡迹
[享]	淳諄谆醇鶉鹑
[內]	枘納肭芮蚋衲訥鈉
[公]	兖
[兴]	誉
[冗]	沉
[別]	捌
[刪]	珊跚
[办]	协胁
[勻]	均筠昀鈞韵
[卖]	椟渎牍犊窦续觌读赎黩
[卽]	鯽
[去]	怯砝
[又1]	叹汉
[又2]	劝权欢观
[吕]	稆莒鋁閭櫚
[吳]	虞蜈誤
[啬]	墙嫱樯蔷
[嗇]	墻嬙檣薔
[囪]	窗
[圣]	怪柽
[夹]	陕
[奧]	噢懊澳燠襖
[宁]	咛拧柠泞狞聍苧
[寸]	紂葤纣荮肘討讨酎
[己]	圮妃
[帛]	棉
[广]	圹扩旷犷矿纩邝
[开]	形邢
[強]	犟糨襁鏹
[彔]	氯碌逯
[彦]	諺
[急]	稳
[执1]	亵势热
[执2]	垫执挚絷蛰贽鸷
[斥]	訴诉
[既]	慨暨
[殳]	殁没
[爭]	諍錚
[爲]	僞
[爻]	駁驳
[眔]	鰥鳏
[老]	姥
[舌2]	恬栝
[舌]	刮括活闊阔聒蛞話话颳鴰鸹
[茲]	嵫慈滋糍鷀
[虛]	墟覷
[虫]	浊烛独触
[龍]	襲
[龙]	袭
[𤇾]	犖
[𥁕]	瘟韞
㐌	拖迤
㐫	垴恼脑
㐬	旒流鎏琉硫鋶锍
㐱	殄餮珍畛疹胗診诊趁軫轸
㒼	瞞蟎蹣顢
㓞	恝瘛挈
㔷	陋
㕡	壑
㕣	兗沿船鉛铅
㚇	糉
㚒	陝
㝉	伫苎贮
㝵	得碍鍀锝
㠯	耜
㡭	繼
㢆	缠
㣎	穆
㥯	穩
㫗	厚
㬎	濕隰
㱿	彀愨殻殼慤毂穀觳轂
䍃	徭繇鰩鷂
䍜	罹
䏌	佾
䜌	孌孿巒彎灣戀攣欒灤臠蠻變鑾鸞
䧹	應膺鷹鹰
一	一
丁	丁仃厅叮打汀灯玎町疔盯耵訂订酊釘钉頂顶
丂	朽
七	柒七
万	万劢疠虿迈
丈	丈仗杖
三	三仨叁叄閆闫
上	上让
下	下吓忑虾
丌	丌
不	不杯罘鈈钚
与	与屿欤
丏	沔眄麪
丐	丐鈣钙
丑	丑妞忸扭狃紐纽羞饈馐衄鈕钮
专	专传抟砖转啭
且	且俎咀姐徂殂沮菹狙疽祖租粗組组苴蛆詛诅趄阻雎駔驵齟龃
丕	丕呸坯胚苤邳
世	世屉屜泄紲绁貰贳
丘	丘蚯邱
丙	丙柄炳病邴
业	业邺
东	东冻岽栋胨鸫
丝	丝咝鸶
丟	丟丢
丞	丞卺巹拯蒸
两	两俩辆魉
严	严俨酽
並	並碰踫
丧	丧
丨	丨
丩	糾纠虬虯赳
个	个
丫	丫吖
丬	丬妆状
中	中仲冲忠忡沖盅种肿舯衷钟
丰	丰沣蚌
串	串
临	临
丶	丶
丸	丸紈纨芄
丹	丹坍旃
为	为伪妫沩
主	主住拄柱注炷疰蛀註駐驻麈
丽	丽俪逦郦酾骊鲡鹂
举	举榉
丿	丿
乂	刈
乃	乃仍奶扔氖艿鼐
久	久柩灸玖疚
乇	乇吒奼托託
么	么仫
义	义仪舣蚁议
之	之芝
乌	乌呜坞邬钨
乍	乍作咋怍怎昨柞炸痄砟祚窄搾榨笮胙舴蚱詐诈迮酢阼
乎	乎呼烀軤轷
乏	乏泛眨砭窆貶贬
乐	乐栎泺烁砾跞轹铄
乒	乒
乓	乓
乔	乔侨娇峤挢桥矫荞轿鞒骄
乖	乖
乘	乘剩嵊
乙	乙亿忆挖艺呓釔钇
乚	乩扎軋轧
九	九仇宄尻旭犰究艽軌匭轨匦馗鳩鸠鼽
乞	乞仡吃圪屹汔疙紇纥虼訖讫迄
也	也他地她弛池牠迆酏馳驰
习	习
乡	乡芗飨
书	书
买	买卖荬
乱	乱
乳	乳
亂	亂
了	了疗辽釕钌
予	予妤序抒杼紓纾豫野墅預蕷预蓣
争	争净峥挣狰睁筝诤铮
事	事
二	二
于	于吁圩宇汙盂盱竽紆纡芋迂
亏	亏圬污肟
云	云紜纭耘芸运酝魂
互	互冱
亓	亓
五	五伍
井	井肼阱
亘	亘垣桓洹
亙	亙恆
亚	亚哑垩垭娅桠氩痖
些	些
亞	亞啞埡堊婭椏氬瘂
亟	亟極殛
亡	亡妄忘忙望氓茫盲肓虻邙
亢	亢伉吭坑抗杭沆炕肮航鈧钪閌闶頏颃骯
交	交佼咬姣效校狡皎絞绞胶茭蛟跤較较郊鉸铰餃饺鮫鲛
亥	亥刻劾咳垓孩核氦胲該该賅赅閡阂陔頦颏駭骇骸
亦	亦奕弈
产	产铲
亨	亨哼烹
亩	亩
享	享
京	京凉惊掠晾椋涼琼諒谅鯨鲸黥
亭	亭停婷葶
亮	亮
亲	亲榇
亶	壇嬗擅檀氈澶羶膻顫颤
人	人认
仁	仁佞
仄	仄昃
仅	仅
今	今吟妗琴芩衾衿鈐钤黔
介	介价尬疥芥蚧阶骱
仌	冫
从	丛从怂枞纵耸苁
仑	仑伦囵抡沦纶论轮
仓	仓伧创呛怆戗抢枪沧炝疮舱苍跄
仕	仕茌
付	付咐拊符苻跗附駙驸鮒鲋
仙	仙
代	代岱玳袋貸贷黛
令	令伶冷呤囹岭怜拎柃泠玲瓴矜羚翎聆苓蛉邻鈴铃領嶺领齡龄
以	以似姒拟苡
件	件
任	任恁荏賃赁
企	企
伇	役疫
伊	伊咿
伏	伏茯袱
伐	伐垡筏閥阀
休	休咻庥貅髹鵂鸺
众	众
会	会侩刽哙桧浍烩狯绘脍荟郐
伞	伞
伤	伤
位	位蒞莅
体	体
何	何
佘	佘畲賒赊
余	余叙溆徐敘漵斜涂塗狳畬蜍途酴餘馀
佥	佥俭剑捡敛潋蔹检殓猃睑硷签脸莶裣险验
佩	佩珮
侃	侃
來	來崍徠淶睞萊賚錸
侖	侖倫圇崙掄淪綸論輪
侯	侯候喉堠猴瘊篌糇緱缑餱
侵	侵
便	便緶缏鞭
保	保堡煲葆裒褒褓
俞	俞偷喻嵛愈癒愉揄榆毹渝瑜瘉窬腧蝓覦觎諭谕輸输逾
信	信
修	修
倉	倉傖創嗆愴戧搶槍滄熗瘡艙蒼蹌
倝	乾幹擀斡翰瀚韓韩
做	做
傘	傘
僉	僉儉劍撿斂瀲蘞檢殮獫瞼礆簽臉薟襝險驗鹼
儿	儿
兀	兀杌虺阢髡
允	允吮狁
元	元冠园朊沅玩芫远阮頑顽黿鼋
兄	兄况況貺贶
充	充統统茺銃铳
兆	佻兆姚挑晁桃洮珧眺祧窕跳逃銚铫鼗
兇	兇
先	先冼宪洗筅詵诜跣选酰銑铣
光	光咣恍桄胱觥
克	克剋氪
兌	兌悅稅脫蛻說銳閱
免	免冕勉娩挽晚浼輓鞔
兑	兑悦税脱蜕説说鋭锐閲阅
兒	倪兒猊睨霓鯢鲵
兔	兔堍菟
党	傥党谠
兜	兜篼蔸
兢	兢
入	入
內	內吶
全	全拴栓痊筌荃詮诠輇辁醛銓铨
兩	倆兩輛魎
八	八叭扒趴
公	公忪瓮蚣訟讼頌颂
六	六
兮	諡兮
兰	兰拦栏烂
共	供共哄恭拱洪烘珙蕻閧鬨龔龚
关	关联
兴	兴
兵	兵浜
其	其基旗期棋欺淇琪祺箕綦萁蜞騏骐麒
具	俱具惧犋颶飓
典	典碘腆
兹	兹孳磁鹚
养	养
兼	兼嫌慊搛歉縑缣蒹謙谦賺赚鶼鹣
兽	兽
冀	冀驥骥
冂	冂
内	内呐纳讷钠
冈	冈刚岗纲钢
冉	冉聃苒蚺髯
冊	冊柵
冋	扃炯苘迥
册	册栅
再	再
冒	冒勖勗帽瑁
冓	媾構溝篝耩覯觏講購遘鞲韝
冖	冖
冗	冗
冘	忱枕沈眈耽鴆鸩
写	写泻
军	军恽挥晕晖浑珲皲荤诨辉郓
农	侬农哝浓脓
冤	冤
冥	冥幂暝溟瞑螟
冬	佟冬咚氡疼終终螽鼕
冯	冯
冰	冰
准	准
几	几叽机玑矶肌虮讥飢饥麂
凡	凡帆梵矾釩钒
凤	凤
凭	凭
凵	凵
凶	凶汹酗
凸	凸
凹	凹
出	出咄拙础絀绌茁詘诎黜
击	击
函	函涵菡
凿	凿
刀	刀刂叨忉釗钊
刁	刁叼
刃	仞刃紉纫軔轫韌韧
刅	梁墚樑粱
分	份分吩坌忿扮棼氛汾玢盆湓盼粉紛纷芬貧贫酚頒颁鼢
切	切彻沏砌窃
刍	刍皱绉诌趋邹雏驺
刑	刑型硎荆荊
列	例冽列咧洌烈裂趔
刘	刘浏
则	侧则厕恻测铡
初	初
删	删姗
別	別
利	俐利梨犁猁琍痢莉蜊黧
刪	刪姍
别	别
到	倒到
制	制掣製
刷	刷唰涮
刹	刹剎
刺	刺
則	側則厠廁惻測鍘
剌	剌喇瘌
前	前湔煎箭翦譾
剝	剝
剥	剥
剪	剪謭谫
劉	劉瀏
力	仂力叻肋泐
办	办
加	伽加咖哿嘉架枷珈痂瘸笳茄袈賀贺跏迦駕驾
务	务雾
劣	劣
劦	勰協脅荔
动	动恸
助	助鋤锄
劫	劫
劳	劳唠崂捞涝痨耢铹
勇	勇湧踴
勒	勒嘞鰳鳓
務	務霧
勞	勞嘮嶗撈澇癆耮鐒
勹	勹
勺	勺妁尥杓灼的約喲葯约哟药芍豹趵酌釣钓
勻	勻
勾	勾构沟购鈎钩
勿	刎勿吻囫物笏芴
匀	匀钧
包	刨包匏咆孢庖抱泡炮狍疱皰胞苞袍跑鉋雹颮飑飽饱鮑鲍齙龅
匆	匆
匈	匈洶胸
匊	掬菊鞠鞫麴麹
匋	啕掏淘萄陶
匕	匕庀牝
化	化訛讹貨货靴
北	北邶
匚	匚
匝	匝咂砸
匠	匠
匡	匡哐框眶筐誆诓
匱	匱櫃
匹	匹
区	伛区呕妪岖怄抠枢欧殴沤瓯眍讴躯驱鸥
医	医
匽	偃堰揠郾鼴
匿	匿慝暱
區	傴區嘔嫗嶇慪摳樞歐毆漚甌瞘謳軀驅鷗
十	什十叶汁計计針针
卂	汛訊讯迅
千	仟千忏扦歼纤芊迁跹釺钎阡
卅	卅
升	升昇
午	仵午忤杵許滸许浒迕
卉	卉
半	伴判半叛拌泮畔絆绊胖袢
华	华哗桦铧骅
卑	俾卑啤埤婢庳捭牌痺睥碑稗脾萆蜱裨郫陴髀鵯鹎鼙
卒	卒啐悴淬猝瘁碎粹萃誶谇醉
卓	倬卓悼掉桌棹淖焯綽绰罩踔
单	冁单婵弹惮掸殚瘅禅箪蝉觯郸阐
南	南喃楠罱腩蝻
卜	仆卜扑朴补訃讣赴釙钋
卞	卞忭汴苄
卟	卟
占	佔占坫帖萜战拈毡沾霑点玷砧站粘苫覘觇貼贴钻阽鮎鲇黏點
卡	佧卡咔胩
卢	卢垆庐栌泸炉胪舻芦轳颅驴鲈鸬
卣	卣
卤	卤
卩	卩
卫	卫
卬	仰迎
卮	卮栀
卯	卯峁昴柳泖聊茆貿贸鉚铆
印	印抑茚
危	危桅詭诡跪
即	即唧鲫
却	却脚
卵	卵
卷	倦卷圈捲綣绻蜷錈锩鬈
卸	卸啣
卻	卻腳
卿	卿
厂	厂
厄	厄呃扼苊軛轭
历	历呖坜枥沥疬苈雳
厉	励厉砺粝蛎
压	压
厌	厌厣恹靥餍魇
厓	崖捱涯睚
原	原塬愿源螈願
厥	劂厥噘撅橛獗蕨蹶鐝镢鱖鳜
厨	厨橱蹰
厭	厭厴壓懨靨饜魘
厲	勵厲礪糲蠣
厶	厶私
厷	肱閎闳雄
去	去祛
厽	垒
县	县悬
参	参惨掺毵渗碜糁骖黪
參	參慘摻毿滲磣糝蔘驂黲
又	又
叉	叉杈汊衩釵钗
及	及吸圾岌极汲笈級级芨趿
友	友
双	双
反	反坂扳板版畈舨販贩返鈑钣阪飯饭
发	发废拨泼
叔	叔寂椒淑督菽
叕	啜掇綴缀裰輟辍
取	取娶諏诹趣陬鯫鲰
受	受授綬绶
叚	假暇瑕瘕葭蝦遐霞
叟	叟嗖嫂搜溲瘦瞍艘螋鎪锼颼飕餿馊
叠	叠
叢	叢
口	口叩扣筘釦
古	估古咕嘏姑菇岵怙故枯沽牯祜罟苦蛄詁诂軲轱酤鈷钴骷鴣鸪
句	佝劬句够夠岣拘煦朐枸狗笱苟鉤駒驹鴝鸲齣
另	另
叧	拐枴柺
只	只咫帜枳炽积织职识軹轵
叫	叫
召	劭召怊招昭照沼笤紹绍苕詔诏貂超軺轺迢邵韶髫齠龆
可	可呵坷岢柯珂疴舸苛蚵訶诃軻轲鈳钶
台	冶台始怠怡抬枱殆治炱眙笞紿绐胎苔詒诒貽贻跆迨邰颱飴饴駘骀鮐鲐
史	史駛驶
右	佑右祐醢
号	号枵
司	伺司嗣祠笥詞词飼饲
各	各咯恪格烙珞硌絡络胳袼貉賂赂輅辂酪鉻铬閣擱阁搁雒駱骆骼
合	合哈恰拾搿洽盒給给耠蛤袷鉿铪閤頜颌鴿鸽龕龛
吉	佶吉咭拮桔洁秸結结詰诘頡擷纈颉撷缬髻鮚鲒黠
吊	吊銱铞
同	侗同垌峒恫桐洞硐筒胴茼酮銅铜
名	名茗酩銘铭
后	后垢詬诟逅骺
吏	使吏
向	向响垧晌餉饷
吕	侣吕铝闾榈
君	君捃窘羣群裙郡
吝	吝
吞	吞
吠	吠
否	否痞
含	含晗焓頷颔
启	启
吳	俁吳
吴	俣吴娱误
吹	吹
吾	吾唔圄寤悟捂晤梧浯焐牾痦衙語语鼯齬龉
呂	侶呂
呆	呆
呈	呈埕程裎逞郢酲鋥锃
呉	娛
告	告梏浩牿皓窖誥诰郜酷鋯锆靠鵠鹄
员	勋员圆埙损殒郧陨
呙	剐呙埚娲涡祸窝脶莴蜗锅
周	倜凋周啁彫惆碉稠綢绸蜩調调週雕鯛鲷鵰
命	命
咅	倍蓓剖培掊涪焙瓿碚菩賠赔踣部醅錇锫陪
和	和
咎	咎晷綹绺
咠	戢蕺揖楫緝缉葺輯辑
咢	愕腭萼諤谔鄂鍔锷顎颚鰐鳄鶚鹗齶
咱	咱
咸	减咸喊減碱箴緘缄鹹
咼	剮咼堝媧渦禍窩腡萵蝸鍋
哀	哀鎄锿
品	品榀闆
哉	哉
員	勛員圓塤損殞鄖隕韻
哥	哥歌
哭	哭
唐	唐塘搪溏瑭糖螗醣
商	商墒熵
啇	嘀嫡摘敵滴謫谪適鏑镝
啚	鄙
啬	啬穑
啻	啻膪
善	善繕缮膳蟮鄯鱔鳝
喜	僖喜嘻嬉熹禧
喪	喪
喬	僑喬嬌嶠撟橋矯蕎轎鞽驕
單	單囅嬋彈憚戰撣殫癉禪簞蟬觶鄲闡鼉鼍
喿	噪操澡藻燥繰缲臊躁
嗇	嗇穡
嘗	嘗嚐
器	器
噩	噩鱷
嚣	嚣
嚴	儼嚴巖釅
囂	囂
囊	囊囔攮饢馕
囗	囗
囚	囚泅
四	四泗駟驷
回	回廻徊洄茴蛔迴
囟	囟
因	咽因姻氤洇烟胭茵銦铟
团	团
囪	囪
困	困悃捆梱睏綑閫阃
囱	囱
囷	菌
固	個固崮涸痼錮锢鯝鲴
国	国帼掴蝈
图	图
圂	溷
國	國幗摑蟈
圖	圖
土	吐土徒杜社肚芏釷钍
圣	圣蛏
在	在茬
圭	佳卦掛褂哇圭奎喹蝰娃恚挂桂洼窪畦眭硅蛙街詿诖跬閨闺鞋鮭鲑
圼	捏涅陧
坐	唑坐座挫痤矬脞銼锉
坒	狴陛
坛	坛
坤	坤
坴	睦逵陸
垂	唾垂捶棰睡綞缍錘锤陲
垔	堙湮煙甄鄄
埋	埋
埶	勢熱囈藝褻
執	執墊摯縶蟄贄鷙
堂	堂樘瞠膛螳鏜镗
堇	僅勤堇廑槿瑾覲觐謹谨鄞饉馑
堯	僥嘵堯嬈撓曉橈澆燒磽繞翹蕘蟯蹺鐃饒驍
報	報
塵	塵
墨	墨
壘	壘
士	士
壬	壬妊衽飪饪
壮	壮装
壯	壯奘莊裝
声	声
壳	壳悫
壶	壶
壹	噎壹懿殪
壺	壺
壽	儔壽幬濤燾疇禱籌躊鑄
夂	夂
夃	股
处	处
夅	洚絳绛
夆	峯峰烽蜂鋒锋
备	备惫
夋	俊唆峻悛梭浚狻皴睃竣羧逡酸駿骏黢
夌	凌棱淩稜綾绫菱陵鯪鲮
复	复復覆愎腹蝮複馥鰒鳆
夏	厦嗄夏廈
夐	瓊
夔	夔
夕	夕汐矽穸
外	外
夗	怨眢苑鴛鸳
夙	夙
多	侈哆多爹嗲眵黟
夜	夜掖液腋
夢	夢
大	大馱驮
天	天祆蚕
太	呔太态汰肽酞鈦钛
夫	伕呋夫扶肤芙蚨趺麩麸
夬	决块快筷抉決炔缺袂觖訣诀
夭	夭妖岙沃鋈袄跃飫饫
央	央怏映殃泱秧鞅鴦鸯
夯	夯
失	佚失帙瓞秩跌軼轶迭铁
头	头
夷	咦夷姨痍胰荑
夸	侉刳垮夸挎瓠絝绔胯誇跨
夹	侠夹峡挟浃狭瘗荚蛱郏铗颊
夺	夺
夾	瘞俠愜篋夾峽挾浹狹硖硤莢蛺郟鋏頰
奁	奁
奂	唤奂换涣焕痪
奄	俺埯奄崦庵掩淹罨腌菴醃閹阉鵪鹌
奇	倚剞奇寄崎掎旖椅欹犄猗漪琦畸綺绮騎骑
奈	奈捺萘
奉	俸唪奉捧棒
奋	奋
奏	凑奏揍楱湊腠輳辏
奐	喚奐換渙煥瘓
契	契楔禊葜鍥锲
奔	奔錛锛
套	套
奚	奚溪谿蹊雞鷄鼷
奠	奠
奢	奢
奥	奥
奧	奧
奩	奩
奪	奪
奮	奮
女	女汝釹钕
奴	努呶奴孥帑弩怒胬駑驽
好	好薅
如	如恕洳絮茹銣铷
妇	妇
妒	妒
妟	宴
妥	妥綏绥荽餒馁
妻	凄妻悽棲淒萋
妾	唼妾接霎
委	倭委痿矮萎諉诿逶
姜	姜
姦	姦
威	威崴葳
娄	偻喽娄屡屦嵝搂楼瘘窭篓缕耧蒌蝼褛镂髅
婁	僂嘍婁屢屨嶁摟樓瘻窶簍縷耬蔞螻褸鏤髏
婦	婦
婴	嘤婴撄樱璎瘿缨鹦
嫩	嫩
嬰	嚶嬰攖櫻瓔癭纓鸚
子	仔子孜籽耔
孑	孑
孓	孓
孔	吼孔
孕	孕
字	字
存	存荐鞯
孙	孙狲荪逊
孚	俘孚孵桴殍浮稃脬莩蜉郛
孛	勃渤孛悖脖荸餑饽鵓鹁
孝	哮孝酵
孟	勐孟猛艋蜢錳锰
季	季悸
孫	孫猻蓀遜
孰	塾孰熟
孱	孱潺驏骣
宀	宀
宁	佇宁貯
它	佗坨它柁沱砣舵蛇跎酡鉈铊陀駝驼鴕鸵
宅	咤姹宅詫诧
守	守狩
安	安按案桉氨胺銨铵鞍
宋	宋
完	垸完浣烷皖脘莞院鯇鲩
宏	宏
宓	宓
宕	宕菪
宗	宗棕淙琮粽綜综腙踪鬃
官	倌官棺涫管綰绾菅逭館馆
定	啶定淀碇綻绽腚錠锭靛
宛	剜婉宛惋琬畹碗箢腕菀蜿豌
宜	宜誼谊
宝	宝
实	实
审	婶审渖
客	喀客額额髂
宣	喧宣揎暄楦渲煊碹萱
室	室
宦	宦
宫	宫
宮	宮
宰	宰梓滓
害	割害瞎豁轄辖
家	傢嫁家稼鎵镓
容	容榕溶熔蓉鎔镕
宽	宽髋
宾	傧嫔宾摈槟殡滨缤膑镔髌鬓
宿	宿縮缩蓿
寅	夤寅演
密	嘧密
寇	寇蔻
寒	寒
察	嚓察擦檫鑔镲
寡	寡
實	實
寧	嚀寧擰檸濘獰聹
審	嬸審瀋
寬	寬髖
寶	寶
寸	寸忖村衬
对	对怼
寺	侍寺峙恃痔詩诗
寻	寻浔荨鲟
导	导
寽	埒捋酹鋝锊
寿	俦寿帱涛焘畴祷筹踌铸
封	封幫葑
尃	傅博搏溥簿薄礴縛缚膊賻赙
射	射榭謝谢麝
将	将蒋锵
將	奬將槳漿獎蔣醬鏘
專	傳團糰專摶磚轉囀
尉	尉慰熨蔚
尊	尊撙樽蹲遵鱒鳟
尋	尋潯蕁鱘
尌	樹澍鬪
對	對懟
小	小
少	吵妙少抄杪炒眇渺緲缈秒耖鈔钞
尔	你您妳尔弥猕玺祢迩
尖	尖
尘	尘
尚	倘尚徜惝淌緔绱耥裳趟躺
尝	偿尝
尞	僚嘹寮撩潦燎獠療瞭繚缭遼鐐镣鷯鹩
尤	优尤忧扰犹莸疣魷鱿
尧	侥哓娆尧挠晓桡浇烧硗绕翘荛蛲跷铙饶
尨	厖
就	僦就蹴鷲鹫
尸	尸屍屎
尹	尹笋
尺	尺迟
尼	伲呢坭妮尼怩旎昵泥鈮铌
尽	尽烬荩赆
尾	娓尾艉
尿	尿脲
局	侷局跼鋦锔
层	层
居	倨剧居据椐琚裾踞鋸锯
屆	屆
屈	倔堀屈崛掘窟
届	届
屋	喔屋幄握渥齷龌
屏	屏摒
屑	屑榍
展	展搌碾輾辗
屚	漏
属	嘱属瞩
屠	屠
履	履
屬	囑屬矚
屮	屮
屯	吨囤屯沌炖盹砘窀純蒓纯莼肫鈍钝頓噸顿飩饨
山	山氙汕灿疝秈籼舢訕讪
岁	刿哕岁秽
岂	凯剀垲岂恺桤皑觊铠
岑	岑涔
岔	岔
岛	岛捣
岡	剛岡崗綱鋼
岩	岩
岳	岳
岸	岸
島	島搗
崇	崇
崔	催崔摧璀
崩	嘣崩繃蹦
嵒	癌
嵩	嵩
嵬	嵬
巂	攜
川	圳巛川巡訓训釧钏順顺馴驯
州	州洲酬
巠	剄勁弳徑氫涇烴痙經羥脛莖輕逕陘頸
巢	剿勦巢繅缫
巤	獵臘蠟躐邋鬣
工	功工扛攻杠汞紅葒红荭缸肛舡虹訌讧豇邛筇項项
左	佐左
巧	巧窍
巨	巨拒柜炬矩榘苣詎讵距鉅钜
巩	巩恐蛩跫銎鞏
巫	巫誣诬
差	嗟嵯差搓槎瘥磋蹉鹺鹾
己	屺己杞紀纪芑記记起
已	已
巳	圯巳异汜祀
巴	吧岜巴把筢杷爬爸琶疤葩笆粑耙芭鈀钯靶
巵	梔
巷	巷港
巽	巽撰選饌馔
巾	巾
巿	旆沛霈肺芾
币	币
市	市柿鈰铈
布	佈布怖鈽钸
帅	帅
师	师狮筛蛳
希	唏希欷浠烯稀郗
帘	帘
帚	帚
帝	啼帝碲締缔蒂諦谛蹄
帥	帥
带	带滞
師	師獅篩螄
席	席蓆
帶	帶滯
常	嫦常
干	刊奸干旰杆汗犴矸秆竿罕肝訐讦赶軒轩邗酐頇顸鼾
平	坪平怦抨枰萍砰秤苹評评鮃鲆
年	年
并	併姘并拼瓶胼迸餅饼駢骈
幸	倖幸悻
幺	吆幺
幻	幻
幼	呦坳幼拗窈蚴黝
幽	幽
幾	嘰幾機璣畿磯蟣譏饑
广	广
庄	庄桩脏赃
庆	庆
床	床
应	应
底	底
店	店惦掂踮
庙	庙
庚	庚賡赓
府	俯府腐腑
度	度渡踱鍍镀
庶	庶摭蔗遮鷓鹧
康	康慷糠
庸	傭墉庸慵鏞镛鱅鳙
廉	廉濂簾臁蠊鐮镰
廚	廚櫥躕
廛	廛纏躔
廣	壙廣擴曠獷礦纊鄺
延	埏延涎筵蜒誕诞
廷	庭廷挺梃艇莛蜓鋌铤霆
建	健建楗毽犍腱踺鍵键
廾	廾
廿	廿
开	妍岍开研笄趼開
弁	弁拚
弃	弃
弄	弄
弋	弋甙
式	式弑弒拭試试軾轼
弓	弓芎
弔	弔
引	吲引矧蚓
弗	佛弗彿怫拂氟沸狒砩紼绋艴
弘	弘泓
弟	剃娣弟悌梯涕睇第綈绨递銻锑鵜鹈
弦	弦
弭	弭
弱	弱搦溺篛
強	強
强	强镪
弼	弼
彐	彐
归	岿归
当	当挡档裆铛
彔	淥綠
录	录渌緑绿
彖	喙彖掾椽篆緣櫞缘橼
彗	彗
彘	彘
彝	彜彝
彞	彞
彡	彡杉肜衫釤钐
彤	彤
彥	彥顏
彦	彦谚顔颜
彪	彪
彬	彬
彭	嘭彭澎甏膨蟛
彳	彳
往	往
待	待
後	後
徙	屣徙蓰
從	從慫樅縱聳蓯蹤
御	御禦
微	微徽薇黴
徵	徵懲癥
心	吣心沁芯
必	必毖泌祕秘鉍铋
忌	忌跽
忍	忍認
忒	忒鋱铽
志	志痣誌
忝	忝掭添舔
念	唸埝念捻稔諗谂鯰鲶
忽	唿忽惚鍃锪
思	崽思緦缌腮葸鍶锶鰓鳃
急	急
怱	偬葱
总	总聪
恙	恙
恩	嗯恩摁蒽
息	媳息熄螅
恶	恶
悉	悉蟋
患	患漶
悤	傯璁總聰蔥驄骢
悲	悲
惠	惠穗蕙蟪
惡	噁惡
惢	蕊
愁	愁
意	億噫意憶癔臆薏鐿镱
愛	噯嬡愛曖璦
感	感憾撼
慧	慧
慮	慮攄濾
慶	慶
憂	優憂
憲	憲
戈	划戈戤鳶鸢
戉	鉞钺
戊	戊茂
戋	戋栈残浅盏笺线贱溅践钱饯
戌	戌
戍	戍
戎	戎狨絨绒
戏	戏
成	城成晟盛誠诚鋮铖
我	俄哦娥峨我硪莪蛾鋨锇餓饿鵝鹅
戒	戒械誡诫
戔	戔棧殘淺盞箋綫賤濺踐錢餞
或	域惑或蜮閾阈馘
戚	嘁慼戚槭蹙
戛	嘎戛
戜	鐵
戟	戟
戠	幟熾織職識
截	截
戲	戲
戴	戴
戶	戶户戽护沪
戾	唳戾捩淚
所	所
扁	偏匾扁煸犏碥篇編编翩蝙褊諞谝蹁遍騙骗鯿鳊
扇	扇煽騸骟
扈	扈滬
手	手
才	才材豺財财
扫	扫
找	找
承	承
折	哲哳折浙蜇誓踅逝
抛	抛拋
报	报
拉	啦拉
拜	拜湃
拿	拿鎿镎
持	持
掃	埽掃
掌	掌撑
排	排
掰	掰
携	携
擾	擾
支	伎吱妓屐岐庋忮技支枝歧翅肢芰豉
攴	攴
收	收
攸	倏悠攸筱絛莜
改	改
敄	婺瞀蝥鍪騖骛鶩鹜
敌	敌
敎	教
敏	敏鰵鳘
敕	敕
敖	傲嗷廒敖熬獒聱螯遨鏊驁骜鰲鳌鼇
敝	幣弊彆憋撇敝斃瞥蔽蹩鱉鳖
敞	厰廠敞氅
敢	憨撖敢橄澉瞰闞阚
散	撒散潸霰饊馓
敦	墩憝敦暾燉礅鐓镦
敫	徼敫檄激竅繳缴邀
敬	儆擎敬檠警驚
数	擞数薮
敷	敷
數	擻數藪
文	坟文汶玟玫紊紋纹蚊雯
斑	斑癍
斗	抖斗蚪鈄钭
料	料
斛	斛槲
斤	听圻忻斤昕沂祈芹蕲蘄近靳頎颀
斥	坼拆斥柝
斩	堑崭惭斩暂椠渐錾
斬	塹嶄慚斬暫槧鏨
断	断簖
斯	厮嘶廝撕斯澌
新	新薪
斲	鬭
斷	斷籪
方	仿坊妨彷房放倣方枋紡纺肪舫芳訪访邡鈁钫防魴鲂
於	於淤瘀菸閼阏
施	施
斿	游蝣遊
旁	傍徬旁榜滂磅耪膀蒡螃謗谤鎊镑
旅	旅膂
旋	旋漩璇鏇镟
族	嗾族簇蔟鏃镞
无	呒妩庑怃抚无芜
既	既暨概溉
日	日汨
旦	但坦妲怛担旦疸笪胆袒鉭钽靼
旧	旧
旨	指旨脂詣诣酯
早	早
旬	峋徇恂旬殉洵筍絢绚荀詢询郇
旱	悍捍旱桿焊稈趕
时	埘时莳鲥
昂	昂
昆	崑昆棍混琨緄绲輥辊醌錕锟餛馄鯤鲲
昊	昊
昌	倡唱娼昌猖菖閶阊鯧鲳
明	明盟萌
昏	婚昏閽阍
易	剔埸惕易蜴裼賜赐踢錫锡
昔	借厝惜措昔猎籍藉腊蜡醋錯错鵲鹊
昙	昙
昜	場揚暢楊湯燙盪蕩鐋煬瘍碭腸陽颺餳
昝	偺昝糌
星	惺戥星猩腥醒
春	春椿蝽蠢
昬	緡缗
是	匙堤提是緹缇醍題题
昱	昱煜
昷	媪愠氲温藴蕴腽醖韫
昼	昼
显	显
時	塒時蒔鰣
晃	幌晃
晉	戩晉縉
晋	戬晋缙
晏	晏鼹
晔	晔烨
晝	晝
普	普氆譜谱鐠镨
景	影憬景
晶	晶
智	智
暑	暑
暴	暴曝瀑爆
暹	暹
曄	曄燁
曆	曆
曇	曇罎
曰	曰汩
曲	曲蛐麯
曳	拽曳
更	哽埂更梗硬筻粳綆绠鯁鲠
曷	偈喝揭曷歇蠍渴碣竭羯蝎褐謁藹靄谒蔼霭遏
書	書
曹	嘈曹槽漕糟艚螬遭
曼	墁幔慢曼漫熳縵缦蔓謾谩鏝镘饅馒鰻鳗
曾	僧噌增層憎曾甑繒缯罾贈赠蹭
替	替
最	嘬撮最蕞
朁	僭潛潜簪蠶譖谮
會	儈劊噲會檜澮燴獪繪膾薈鄶
月	刖月钥
有	侑囿宥有洧賄贿郁銪铕鮪鲔
朋	堋朋棚硼綳绷鵬鹏
服	服菔
朔	嗍塑搠朔槊溯蒴
朕	勝塍媵朕滕籐藤腾謄誊騰
朗	朗
朝	嘲廟朝潮
木	木沐
未	味妹寐昧未魅
末	抹末沫秣茉袜
本	本笨缽苯鉢钵
札	札紮
朮	怵朮术沭秫術述
朱	侏姝朱株殊洙珠硃茱蛛誅诛邾銖铢
朵	剁哚垛朵跺躲
杀	杀脎铩
杂	杂
李	李
杏	杏
束	悚束涑竦觫
条	条涤绦鲦
来	崃徕来涞睐莱赉铼
杰	杰
東	凍崬東棟腖鶇
杳	杳
松	凇崧松淞菘鬆
析	晰析淅皙菥蜥
林	啉婪漤林淋琳郴霖
枚	枚
果	倮夥果棵猓稞窠蜾裸裹課课踝錁锞顆颗騍骒髁
枣	枣
枭	枭
枼	喋堞揲渫牒碟蝶諜谍蹀鰈鲽
某	媒某煤謀谋
染	染
柔	揉柔猱糅蹂鞣
查	喳揸查楂渣猹碴餷馇齄
柬	揀柬楝煉練諫谏鍊
柰	柰
柴	柴
标	标
树	树
栗	傈慄栗溧篥
桀	傑桀
桑	嗓搡桑磉顙颡
桼	漆膝
條	條滌縧鰷
梟	梟
梦	梦
棄	棄
棗	棗
棘	棘
棠	棠
森	森
楚	憷楚礎
楞	愣楞
業	業鄴
榮	嶸榮蠑
樂	樂櫟濼爍礫藥躒轢鑠
樊	攀襻樊礬
橐	橐蠹
欠	坎莰欠砍肷芡飲饮
次	咨姿恣次瓷粢茨諮谘資资趑餈
欣	掀欣鍁锨
欮	闕阙
欶	嗽漱簌蔌
款	款
止	址扯止祉耻芷趾
正	征惩怔政整正症証证鉦钲
此	呲此疵眥眦砦紫茈訾貲赀雌髭齜龇
步	步
武	武賦赋鵡鹉
歪	歪
歰	澀
歲	劌噦歲穢
歷	嚦壢櫪歷瀝癧藶靂
歸	巋歸
歹	歹
死	死
殳	投殳骰
段	椴段煅緞缎鍛锻
殷	慇殷
殸	磬罄聲謦馨
殹	翳醫
殺	殺鎩
殿	殿澱癜臀
毀	毀毁燬譭
毄	墼擊繫
毅	毅
毋	毋
母	坶姆拇母
每	侮悔晦梅每莓誨诲酶霉
毒	毒碡纛
比	仳吡妣屁庇批枇比毙琵砒秕紕纰舭芘蚍
毕	哔毕筚荜跸
毘	媲毗篦蓖貔
毚	攙纔讒饞
毛	旄毛牦耄耗髦
毫	毫
毳	撬橇毳
氏	氏紙纸舐芪衹
氐	低坻抵柢氐牴砥祗羝胝詆诋邸骶鴟鸱
民	岷抿愍民泯珉眠苠
气	忾气汽饩
氣	愾氣餼
水	水
永	咏永泳詠
氾	氾犯範范
求	俅救求球裘賕赇逑
汇	汇
江	江茳鴻鸿
沓	沓踏
沙	娑挲桫沙痧砂紗纱莎裟鯊鲨
河	河菏
泉	泉線缐腺
法	法珐琺
波	啵婆波菠
泣	泣
泪	泪
泰	傣泰
泵	泵
洛	洛
津	津
派	派蒎
海	嗨海
浸	浸
涉	涉
涩	涩
淫	淫霪
淵	淵
淼	淼
渊	渊
渠	渠磲蕖
湿	湿
準	準
溼	溼
满	懑满
滿	懣滿
漸	漸
火	伙火鈥钬
灭	灭
灰	咴恢灰盔詼诙
灵	棂灵
灶	灶
災	災
灾	灾
炊	炊
炎	剡啖毯氮淡炎焱琰痰談谈賧赕郯錟锬
炙	炙
炭	炭碳
為	偽為
烏	嗚塢烏鄔鎢
烕	滅
烦	烦
焉	嫣焉蔫鄢
焚	焚
無	嘸嫵廡憮撫無蕪
焦	僬劁噍憔樵焦瞧礁蕉譙谯醮蘸鷦鹪
然	撚然燃
煞	煞
煩	煩
熊	熊
熏	勳壎曛熏燻獯薰醺
熙	熙
燕	嚥燕
營	營
燮	燮躞
爪	抓爪笊
爭	凈崢掙淨爭猙睜箏
爯	稱
爰	媛援暖爰瑗緩缓諼谖鍰锾
爱	嗳嫒暧爱瑷
爲	僞嬀潙爲
爵	嚼爝爵
父	斧父釜滏
爷	爷
爻	爻
爽	爽
爾	彌瀰獼爾璽禰邇
爿	妝戕爿牀狀
牆	牆
片	片
牙	伢呀岈牙砑芽蚜訝讶迓雅鴉鸦
牚	撐
牛	牛
牟	侔哞毪牟眸蛑
牡	牡
牢	牢
牧	牧
牵	牵
特	特
牽	牽縴
犀	墀樨犀
犬	犬畎
犮	拔菝祓紱绂茇跋鈸钹髮魃鮁鲅黻
狂	狂誑诳逛
狄	狄荻逖
狊	闃阒
狱	狱
猋	飆飙
猪	橥潴猪
献	献谳
獄	嶽獄
獸	獸
獻	獻讞
玄	泫炫玄痃眩絃舷鉉铉
率	摔率蟀
玉	玉玨珏鈺钰頊顼
王	旺枉汪王
班	班
瑟	瑟
瓜	呱孤菰弧狐瓜胍觚
瓦	佤瓦
甘	坩箝柑泔甘疳紺绀苷蚶邯酣鉗钳甘欠嵌
甚	勘堪戡斟椹湛甚葚諶谌
甜	甜
生	姓性旌牲生甥眚笙胜
産	剷鏟産產
甦	甦
用	佣拥用痈
甩	甩
甫	匍葡哺圃埔捕晡浦蒲甫脯莆補輔辅逋鋪铺黼
甬	俑恿捅桶涌甬痛蛹誦诵踊
甯	甯
田	佃田甸畋鈿钿
由	冑妯宙岫抽柚油由笛胄舳蚰袖軸轴迪邮釉鈾铀鼬
甲	匣呷岬押柙狎甲胛鉀钾閘闸鴨鸭
申	伸呻抻申砷神紳绅胂
电	电電
男	男
甹	俜娉聘騁骋
画	画
甾	淄甾緇缁輜辎錙锱鯔鲻
畀	淠畀痹箅
界	界
畏	偎喂煨猥畏隈餵
畐	副匐蔔富幅福蝠輻辐逼
留	籀榴溜熘留瘤遛鎦镏餾馏騮骝
畚	畚
畜	搐畜蓄
畝	畝
畟	稷謖谡
畢	嗶畢篳蓽蹕
略	略
畧	撂
番	幡播潘藩燔番皤翻蕃蟠蹯鄱
畫	劃畫
異	異翼
當	噹擋檔當襠鐺
畺	僵殭疆礓繮缰薑韁
畾	儡
疊	疊
疋	疋
疌	婕捷睫
疏	梳疏蔬
疐	嚏
疑	凝嶷擬疑癡礙
疒	疒
疟	疟
疾	嫉疾蒺
瘪	瘪
癟	癟
癸	揆暌癸睽葵闋阕
登	凳噔嶝橙澄燈登瞪磴簦證蹬鄧鐙镫
發	廢撥潑發
白	伯帕帛怕拍啪柏泊箔珀白碧粕舶迫鉑铂魄
百	佰百貊陌
皀	簋
皂	唣皂
皆	偕喈揩楷皆蒈諧谐鍇锴階
皇	凰徨惶湟煌皇篁蝗遑隍鰉鳇
皋	嗥槔皋翱
皐	皐
皮	坡帔彼披玻疲皮破簸被跛鈹铍陂頗颇
皿	皿
盃	盃
盈	楹盈
益	嗌溢益縊缢謚谥鎰镒隘
盍	嗑溘盍瞌磕豔艷闔阖
盎	盎
盐	盐
监	尴槛滥监褴
盖	盖
盗	盗
盘	盘
盜	盜
盡	儘燼盡藎贐
監	尷檻濫監艦襤鍳鑑鑒鹽
盥	盥
盧	壚廬櫨瀘爐盧臚艫蘆轤顱驢鱸鸕
目	目苜鉬钼
直	值埴植殖直置
相	厢廂想湘相箱緗缃葙
盾	循盾遁
省	省
眉	媚嵋楣湄猸眉鎇镅鶥鹛
看	看
真	嗔填慎滇真稹縝缜鎮镇闐阗顛巔癲颠巅癫
眾	眾
着	着
睘	儇圜寰擐環繯缳還鬟
睪	嶧懌擇籜澤睪繹譯釋鐸驛
睾	睾
睿	濬睿
瞢	懵瞢
瞿	懼氍癯瞿衢
矍	攫矍蠼
矗	矗
矛	懋矛茅蟊袤
矞	橘譎谲鷸鹬
矢	矢
矣	俟唉埃挨矣誒诶
知	痴知蜘踟
石	庹拓斫柘炻石硕碩磔跖
砉	砉
磊	磊
示	示祁視视
礼	礼
祘	蒜
祝	咒祝
祟	祟
票	剽嘌嫖標漂瓢瘭瞟票縹缥膘螵鏢镖飄飘驃骠鰾鳔票寸
祭	傺瘵祭際
祿	祿
禀	凛廪懔檩禀
禁	噤禁襟
禄	禄
禹	禹踽齲龋
禺	偶喁寓愚禺耦藕遇隅
离	漓璃离篱縭缡蓠螭魑
禼	竊
禽	噙擒檎禽
禾	禾
禿	禿秃
秀	秀綉绣莠誘诱透銹锈
秉	秉
秋	啾愀揪楸湫瞅秋鍬锹鞦鬏鰍鳅
科	科蝌
秦	嗪榛溱秦臻蓁螓
称	称
移	移
稚	稚
稟	凜廩懍檁稟
稣	稣
稽	嵇稽
穌	穌蘇囌
穴	穴
穷	穷
穹	穹
空	倥崆控空箜腔
穿	穿
突	突
窑	窑
窜	撺窜蹿镩
窮	窮
竄	攛竄躥鑹
立	垃砬立笠粒颯飒
竖	竖
竞	竞
竟	境獍竟鏡镜
章	嫜嶂幛彰樟漳獐璋瘴章蟑鄣障
童	僮幢憧撞潼疃瞳童艟鐘
競	競
竹	竹竺笃筑築篤
笑	笑
笔	滗笔
筆	潷筆
等	等
筋	筋
答	答
策	策
筮	噬筮
箍	箍
算	算篡纂攥
節	櫛癤節
篮	篮
籃	籃
米	咪敉眯米脒麋
类	类
粟	僳粟
粤	粤
粥	粥鬻
粦	嶙憐燐瞵磷粼膦轔辚遴鄰鱗鳞麟
粪	粪
粲	燦璨粲
粵	粵
糞	瀵糞
糸	糸
系	係系
素	嗉愫素
索	嗦索
累	嫘摞漯瘰累縲缧螺鏍镙騾骡
細	細
絕	絕
絜	潔
絲	噝絲鷥
綿	綿
縣	懸縣
繁	繁蘩
繭	繭
纍	纍
细	细
绝	绝
继	继
绵	绵
缶	缶
网	网
罔	惘網罔輞辋魍
罗	啰椤猡箩罗萝逻锣
罙	探深琛
罚	罚
罡	罡
罢	摆罢罴
罪	罪
罰	罰
署	曙署薯
罷	擺罷羆襬
羁	羁
羅	囉欏玀籮羅蘿邏鑼
羈	羈
羊	佯咩庠徉样氧洋烊痒祥羊翔蛘詳详
羋	羋芈
羌	羌蜣
美	美鎂镁
羔	禚窯糕羔
羕	樣漾
羨	羡羨
義	儀義艤蟻議
羲	曦犧羲
羸	羸蠃
羹	羹
羽	栩羽詡诩
羿	羿
翁	嗡翁蓊
翌	翊翌
翏	寥廖戮瘳繆缪膠蓼謬谬醪鷚鹨
習	摺熠習褶
翕	歙翕
翟	戳擢曜櫂濯糴糶翟耀躍
翠	翠
老	佬栳老銠铑
考	拷栲烤考銬铐
者	堵楮渚煮睹箸緒绪翥者褚賭赌赭鍺锗
耆	嗜耆蓍鰭鳍
而	恧而耐鮞鲕鴯鸸
耍	耍
耑	喘惴揣湍瑞端踹遄顓颛
耒	耒誄诔
耳	佴恥洱珥耳鉺铒餌饵
耴	輒辄
耶	揶椰爺耶
耷	耷
耿	耿
聂	嗫慑摄滠聂蹑镊颞
聖	檉聖蟶
聚	聚鄹驟骤
聯	聯
聶	囁懾攝灄聶躡鑷顳
聽	廳聽
聿	律聿
肃	啸箫肃萧潇
肅	嘯簫繡肅蕭瀟鏽
肆	肄肆
肇	肇
肉	肉
肖	俏削哨宵峭悄捎梢消硝稍潲筲綃绡肖艄蛸誚诮趙逍銷销霄鞘魈
肙	娟捐涓狷絹绢鵑鹃
肥	淝肥
肩	掮肩
肯	啃肯
育	唷毓育
肴	崤淆肴餚
胃	喟彙渭猬胃蝟謂谓
背	背褙
胡	湖煳猢瑚糊胡葫蝴醐鬍鶘鹕
胤	胤
胥	婿糈胥醑
能	態能
脈	脈
脉	脉
脊	嵴瘠脊
脩	脩
膚	膚
臣	臣
臤	堅慳鏗鰹緊腎賢
臥	卧臥
臧	臧贓
臨	臨
自	洎自
臬	臬鎳镍
臭	嗅溴糗臭
臯	臯
臱	邊籩
至	侄垤姪桎窒膣耋至蛭輊轾郅
致	緻致
臺	檯臺薹
臼	桕臼舅舊
臽	掐焰燄萏諂谄陷餡馅
臾	庾瘐腴臾萸諛谀
臿	插歃鍤锸
舀	滔稻舀蹈韜韬
舁	舁
舂	樁舂
舄	寫瀉舄
與	嶼歟舆與譽輿
興	興
舉	櫸舉
舌	憩舌
舍	啥捨猞舍舒
舛	舛
舜	瞬舜
舞	舞
舟	舟
般	搬瘢盤磐般
艮	哏垠垦很恨恳根狠痕眼艮艰艱茛裉墾懇跟銀银限齦龈
良	娘浪蒗狼琅稂粮良莨踉酿鋃锒閬阆
色	色銫铯
艳	滟艳
艾	哎砹艾
节	栉疖节
芒	硭芒
花	花
芻	皺縐芻謅趨鄒雛騶
苏	苏
苗	喵描猫瞄苗貓錨锚鶓鹋
若	偌喏惹箬若諾诺鍩锘
英	瑛英
茧	茧
茲	茲
茶	搽茶
茸	茸
荅	嗒塔搭瘩褡
草	草
荒	慌荒謊谎
荣	嵘荣蝾
荷	嗬荷
荼	荼
莫	募墓嫫寞幕冪慕摸摹暮模漠瘼糢膜莫蓦蟆謨谟貘鏌镆饃馍驀
获	获
莽	漭莽蟒
菐	僕濮噗幞撲樸璞蹼醭鏷镤
華	嘩樺華譁鏵驊
萨	萨
萬	勱癘萬蠆邁
落	落
葉	葉
著	著躇
葛	噶葛
葬	葬髒
蒐	蒐
蒙	懞朦檬濛矇礞艨蒙蠓
蒦	劐獲穫蠖護鑊镬鸌鹱
蓋	蓋
蓝	蓝
蓟	蓟
蔑	篾蔑蠛衊襪
蔡	礤蔡
蔺	蔺躏
薛	孽薛蘖
薦	薦韉
薩	薩
藍	藍
藏	臟藏贜
虍	虍
虎	唬琥虎
虏	掳虏
虐	瘧虐謔谑
虑	摅滤虑
虒	搋篪褫遞
虔	虔
處	處
虖	滹罅
虚	嘘虚觑
虛	噓虛
虜	擄虜
號	號饕
虧	虧
虫	虫融蟲
虱	虱蝨鯴鲺
虽	虽
蚤	搔瘙蚤騷骚鰠鳋
蚩	嗤媸蚩
蛊	蛊
蛋	蛋
蜀	濁燭獨蜀觸躅鐲镯髑
蜜	蜜
蠡	蠡
蠱	蠱
血	卹恤洫血
衅	衅
衆	衆
行	桁珩絎绗荇行衡蘅
衍	愆衍
衛	衛
衣	依衣銥铱
表	婊表裱錶
衮	滚磙衮
衰	榱簑蓑衰
袁	園猿袁轅辕遠
袅	袅
袞	滾袞
裊	嬝裊
裔	裔
褱	壞懷
襄	嚷壤孃攘曩瓤禳穰襄讓釀鑲镶驤骧
西	哂晒栖洒牺硒粞舾茜西
要	崾腰要
覃	潭簟罈蕈覃譚谭鐔镡
見	峴梘現硯筧莧蜆見
規	窺規
覓	覓
親	櫬襯親
覽	攬欖纜覽
见	岘枧现砚笕舰苋蚬见
规	窥规
觅	觅
览	揽榄缆览
角	桷确角
觜	嘴觜
解	廨懈獬蟹解邂
言	唁狺言這
訇	訇
設	設
詹	儋擔檐澹瞻簷膽蟾詹譫谵贍赡
諸	儲櫧諸
讲	讲
设	设
诸	储槠诸
谷	俗峪欲慾浴裕谷鵒鹆
豆	痘短豆逗頭
豈	凱剴塏愷榿皚覬豈鎧
豊	澧禮醴體鱧鳢
豎	竪豎
豐	灃豐酆
豕	豕
豖	冢塚啄涿琢瘃諑诼
豚	豚
象	像橡蟓象
豦	劇噱據璩遽蘧醵
豪	嚎壕濠蠔豪
豬	櫫瀦豬
豸	豸
貌	藐貌邈
貝	唄敗狽貝鋇
貞	偵幀楨湞禎貞
負	負
貢	槓貢
貪	貪
貫	慣摜貫
責	債嘖幘漬磧積簀績責賾蹟
貳	膩貳
貴	憒潰簣繢聵蕢貴饋
買	蕒買賣
費	費鐨
賁	僨噴墳憤賁鱝
賈	價賈
賊	賊
賏	罌
賓	儐嬪擯檳殯濱繽臏賓鑌髕鬢
賞	償賞
質	質躓
賴	懶瀨獺癩籟賴
贅	贅
贊	攢瓚纘讚贊趲躦鑽
贛	戇贛
贝	呗坝狈贝败钡
贞	侦帧桢浈祯贞
负	负
贡	贡
责	债啧帻渍碛箦绩责赜
质	质踬
贪	贪
贯	惯掼贯
贰	腻贰
贲	偾喷愤贲鲼
贵	匮愦溃篑缋聩蒉贵馈
费	费镄
贼	贼
贾	贾
赏	赏
赖	懒濑獭癞籁赖
赘	赘
赞	攒瓒缵赞趱躜
赣	戆赣
赤	哧赤赦螫郝
赫	嚇赫
走	走
赵	赵
越	樾越
足	促捉浞足齪龊
路	潞璐路露鷺鹭
身	身
躬	躬
車	厙庫褲硨車
軍	惲揮暈暉渾琿皸葷諢軍輝運鄆
軎	軎
軟	軟
輦	攆輦
轟	轟
车	厍库裤砗车
软	软
轰	轰
辇	撵辇
辛	莘辛鋅锌
辜	辜
辞	辞
辟	僻劈噼壁嬖擗擘檗蘗璧甓癖臂薜襞譬辟避鐾闢霹
辡	瓣辦辨辩辫辮辯
辣	辣
辥	櫱
辭	辭
辰	唇娠宸振晨脣蜃賑赈辰震
辱	溽縟缛耨蓐褥辱
農	儂噥濃膿農
边	笾边
达	哒挞跶达闼鞑
过	挝过
这	这
进	进
连	涟琏莲裢连链鲢
迷	瞇謎谜迷醚
追	槌縋缒追
退	煺腿褪退
送	送
适	适
逆	逆
逐	逐
通	嗵通
速	速
造	糙造
逢	篷縫缝蓬逄逢
連	漣璉蓮褳連鏈鰱
進	進
逸	逸
遀	髓
遂	燧遂邃隧
過	撾過
道	導道
達	噠撻躂達闥韃
遗	遗
遣	繾缱譴谴遣
遲	遲
遷	躚遷韆
遺	遺
邑	悒挹邑
邓	邓
邕	邕
那	哪娜挪那
邦	帮梆綁绑邦
邪	琊邪
郎	啷廊榔瑯螂郎
郑	掷踯郑
郭	崞廓椁槨郭
郵	郵
都	嘟都
鄉	嚮薌鄉響饗
鄭	擲躑鄭
酉	酉酒醜
酋	猶蕕猷蝤遒酋
配	配
酥	酥
釁	璺釁
采	彩採睬綵菜踩采
里	俚厘喱哩娌悝狸理裏裡貍霾里釐鋰锂鯉鲤
重	動慟種腫董懂衝踵重鍾锺
量	糧量
金	欽撳淦金銜錦
錄	錄
録	録
钅	衔钅钦揿锦
長	倀帳張漲悵棖脹萇賬長
长	伥帐张涨怅枨胀苌账长
門	們問悶燜捫聞鍆門閩閿
閃	閃
閉	閉
閏	潤閏
閑	嫻閑
閒	癇閒鷳竹閒
間	澗簡襇鐧間
閔	憫閔
閵	藺躪
閻	閻
闌	攔斕欄瀾爛蘭讕鑭闌
闖	闖
门	们扪钔门问闷焖闻闽阌
闪	闪
闭	闭
闯	闯
闰	润闰
闲	娴痫闲鹇
间	涧简裥锏间
闵	悯闵
闹	闹
阋	阋
阎	阎
阑	斓澜谰镧阑
阜	埠阜
队	坠队
阳	阳
阴	荫阴
阵	阵
阿	啊婀屙痾錒锕阿
际	际
陆	陆
陈	陈
降	降
陏	堕椭随
陡	陡
陣	陣
除	滁除
陰	蔭陰
陳	陳
隆	癃窿隆
隊	墜隊
隋	墮橢隋隳
隐	瘾隐
隨	隨
隱	癮隱
隶	埭棣逮隶
隸	隷隸
隹	唯堆帷惟推椎淮匯睢濉碓維濰维潍萑誰谁錐锥隹雖騅骓
隺	榷確鶴鹤
隻	隻
隼	榫隼
隽	鎸镌隽
难	傩摊滩瘫难
雀	雀
雁	贋赝雁
集	集
雇	僱雇顧
雉	雉
雋	鐫雋
雍	壅擁甕臃蕹雍饔
雔	售讎雠
雙	雙
雚	勸權歡灌獾罐觀顴颧鸛鹳
雜	雜
雝	癰
離	灕籬蘺離
難	儺攤灘癱難
雨	雨
雩	樗雩
雪	雪鱈鳕
雲	蕓雲
零	零
雷	擂檑蕾鐳镭雷
需	儒嚅孺懦濡糯薷蠕襦需顬颥
霍	嚯攉藿霍
霜	孀霜
霝	酃
霸	壩灞霸
靈	欞靈
青	倩圊婧情晴氰清猜睛箐精腈菁蜻請请錆锖青靓靖静靚靜鯖鲭
非	俳匪榧篚啡徘悱扉斐痱緋绯翡腓菲蜚裴誹诽輩辈霏非鯡鲱
靡	蘼靡
面	湎緬缅腼面靦麵
革	緙缂革
韋	偉圍潿幃煒瑋緯葦諱違闈韋韙
韦	伟围涠帏炜玮纬苇讳违闱韦韪
韭	韭
韰	瀣薤
韱	懺殲籤纖讖谶
音	喑揞暗歆窨諳谙音黯
頁	頁
頃	傾潁穎頃
須	須鬚
頪	類
頹	頹頽
頻	瀕蘋頻顰
顥	灝顥
页	页
顷	倾顷颍颖
须	须
顾	顾
频	濒频颦
颓	颓
颢	灏颢
風	嵐楓瘋碸諷風
风	岚枫疯砜讽风
飛	飛
飞	飞
食	蝕食飭飾
養	癢養鮝鯗鲞
饣	蚀饣饬饰
首	艏首
香	香
馬	嗎媽榪獁瑪碼罵螞馬駡
馭	馭
馮	憑馮
马	吗妈杩犸玛码蚂马骂
驭	驭
骨	滑猾骨鶻鹘
高	搞敲槁犒稿篙縞缟膏蒿嚆藁鎬镐高
髟	髟
鬥	鬥
鬧	鬧
鬩	鬩
鬯	鬯
鬱	鬱
鬲	嗝塥翮膈鎘镉隔鬲
鬼	傀塊愧槐瑰隗餽鬼魁
魏	巍魏
魚	漁魚
魝	薊
魯	嚕擼櫓氌穭鑥魯
鮮	癬蘚鮮
鱼	渔鱼
鲁	噜撸橹氇镥鲁
鲜	癣藓鲜
鳥	蔦鳥
鳳	鳳
鳴	鳴
鴈	贗
鸟	茑鸟
鸡	鸡
鸣	鸣
鹵	滷鹵
鹿	漉簏轆辘鹿麓
麀	鏖
麃	鑣镳
麇	麇
麗	儷曬灑邐酈釃驪鱺鸝麗
麥	嘜麥
麦	唛麦
麻	嘛摩痲磨耱蘑糜縻魔麻麼嬤麽嬷麾
黃	橫潢璜癀磺簧蟥黃黌
黄	横黄黉
黍	黍
黎	藜黎
黑	嘿黑默
黨	儻讜黨
黹	黹
黽	澠繩蠅黽
黾	渑绳蝇黾
鼎	鼎
鼓	瞽臌鼓
鼠	鼠
鼻	濞鼻
齊	儕劑嚌擠濟臍薺蠐躋霽鱭齊齋齎齏
齐	侪剂哜挤斋济脐荠蛴赍跻霁鲚齐齑
齒	嚙齒
齿	啮齿
龍	嚨壟壠寵攏朧櫳瀧瓏矓礱籠聾蘢隴龍龐
龙	咙垄宠庞拢栊泷珑砻笼聋胧茏陇龙
龜	鬮龜
龟	阄龟
龠	瀹鑰龠龥籲
龹	券拳桊眷豢
𠂔	姊秭笫
𠂢	哌
𠤎	叱
𠩺	嫠犛
𡿺	堖惱瑙硇腦
𢛳	德
𢦏	栽裁載载
𣪘	廄
𤇾	塋滎煢熒瑩瀅縈潆瀠螢鎣鶯
𥁕	媼慍氳溫蘊膃醞
𦥯	嚳學澩覺攪鱟
𦰩	嘆歎漢
𧶠	櫝瀆牘犢竇續覿讀贖黷
𬜯	瞒螨蹒颟
